"","id","gene","fiable","new_gene_f","new_gene_s","first_pos","new_gene_f_pos","new_gene_f_s_pos","diff_f","second_pos","new_gene_s_pos","new_gene_s_f_pos","diff_s"
"19","ECK0010-JW0009","yaaH",TRUE,"satP","satP",9946,9928,10494,18,10512,10494,9928,18
"23","ECK0012-JW5001","htgA",TRUE,"yaaW","yaaW",10830,10643,11356,187,11315,11356,10643,-41
"31","ECK0017-JW5002","hokC",TRUE,"mokC","mokC",16769,16751,16903,18,16921,16903,16751,18
"59","none-JW0032","none",FALSE,"caiF","carB",34104,34300,34695,-196,34283,34038,30817,245
"95","ECK0052-JW0050","ksgA",TRUE,"rsmA","rsmA",51627,51609,52430,18,52448,52430,51609,18
"101","ECK0055-JW0053","imp",TRUE,"lptD","lptD",54773,54755,57109,18,57127,57109,54755,18
"111","ECK0060-JW0058","hepA",TRUE,"rapA","rapA",60376,60358,63264,18,63282,63264,60358,18
"123","ECK0069-JW0067","tbpA",TRUE,"thiB","thiB",71002,70984,71967,18,71985,71967,70984,18
"145","ECK0081-JW0078","fruR",TRUE,"cra","cra",84515,84515,85519,0,85519,85519,84515,0
"149","ECK0083-JW0080","mraW",TRUE,"rsmH","rsmH",86581,86581,87522,0,87522,87522,86581,0
"187","ECK0102-JW0099","yacF",TRUE,"zapD","zapD",108361,108343,109086,18,109104,109086,108343,18
"245","ECK0131-JW5010","yadD",TRUE,"rpnC","rpnC",143506,143455,144357,51,144357,144357,143455,0
"261","ECK0139-JW0136","ecpD",TRUE,"yadV","yadV",151966,151948,152688,18,152706,152688,151948,18
"269","ECK0143-JW5892","yadB",TRUE,"gluQ","gluQ",155691,155673,156599,18,156617,156599,155673,18
"275","ECK0146-JW5011","ligT",TRUE,"thpR","thpR",158006,157988,158518,18,158536,158518,157988,18
"293","ECK0155-JW0152","yadR",TRUE,"erpA","erpA",173097,173097,173441,0,173441,173441,173097,0
"299","ECK0158-JW0155","pfs",TRUE,"mtn","mtn",174960,174942,175640,18,175658,175640,174942,18
"331","ECK0175-JW0171","yaeL",TRUE,"rseP","rseP",193033,193033,194385,0,194385,194385,193033,0
"333","ECK0176-JW0172","yaeT",TRUE,"bamA","bamA",194415,194415,196847,0,196847,196847,194415,0
"335","none-JW5015","none",FALSE,"skp","bamA",196848,196969,197454,-121,196958,196847,194415,111
"337","ECK0177-JW0173","hlpA",TRUE,"skp","skp",196969,196969,197454,0,197454,197454,196969,0
"365","ECK0191-JW0187","yaeJ",TRUE,"arfB","arfB",211320,211320,211742,0,211742,211742,211320,0
"373","ECK0195-JW0191","yaeB",TRUE,"trmO","trmO",215392,215374,216081,18,216099,216081,215374,18
"405","ECK0218-JW0207","yafU",TRUE,"BW25113_RS01100","BW25113_RS01100",235251,235233,235589,18,235589,235589,235233,0
"407","ECK0219-JW0208","yafF",TRUE,"BW25113_RS25420","BW25113_RS25420",235677,235587,235865,90,235865,235865,235587,0
"415","ECK0223-JW0212","lpcA",TRUE,"gmhA","gmhA",240030,240030,240608,0,240608,240608,240030,0
"419","ECK0225-JW0214","yafK",TRUE,"dpaA","dpaA",241570,241552,242292,18,242310,242292,241552,18
"427","ECK0229-JW0218","yafM",TRUE,"rayT","rayT",244124,244124,244621,0,244621,244621,244124,0
"429","ECK0230-JW5811","fhiA",TRUE,"BW25113_RS01160","BW25113_RS01160",244863,244845,246557,18,246602,246557,244845,45
"431","ECK0231-JW5812","mbhA",TRUE,"lafU","lafU",246529,246529,247314,0,247314,247314,246529,0
"441","ECK0236-JW0225","ykfJ",TRUE,"BW25113_RS01190","BW25113_RS01190",249954,249966,250172,-12,250220,250172,249966,48
"443","ECK0237-JW0226","prfH",TRUE,"BW25113_RS01195","BW25113_RS01195",250189,250168,250689,21,250689,250689,250168,0
"467","ECK0250-JW5022","yafX",FALSE,"yafX","ykfF",260477,260459,260917,18,261109,261254,261015,-145
"473","ECK0253-JW0240","yafY",FALSE,"yafY","BW25113_RS25435",261839,261821,262264,18,262696,262678,262487,18
"475","none-JW0241","none",TRUE,"BW25113_RS25430","BW25113_RS25430",262282,262264,262491,18,262458,262491,262264,-33
"483","ECK0259-JW0247","insO",TRUE,"BW25113_RS01305","BW25113_RS01305",267541,267475,267900,66,267966,267900,267475,66
"485","none-JW5025","none",FALSE,"ykfC","BW25113_RS01305",268412,268573,269664,-161,268534,267900,267475,634
"495","ECK0265-JW0255","afuB",TRUE,"BW25113_RS01345","BW25113_RS01345",274543,274525,274872,18,274905,274872,274525,33
"497","ECK0266-JW0258","ykgN",TRUE,"BW25113_RS01360","BW25113_RS01360",275753,275825,276073,-72,276091,276073,275825,18
"511","ECK0273-JW0265","yagI",TRUE,"xynR","xynR",284133,284115,284873,18,284891,284873,284115,18
"515","none-JW5028","none",TRUE,"BW25113_RS23270","BW25113_RS23270",286221,286140,286343,81,286349,286343,286140,6
"517","ECK0275-JW0270","yagJ",TRUE,"BW25113_RS01410","BW25113_RS01410",287211,287112,287942,99,287942,287942,287112,0
"525","none-JW5029","none",TRUE,"ykgV","ykgV",290647,290629,290853,18,290871,290853,290629,18
"531","ECK0281-JW0276","yagP",TRUE,"BW25113_RS01450","BW25113_RS01450",293110,293092,293430,18,293520,293430,293092,90
"533","ECK0282-JW0277","yagQ",TRUE,"paoD","paoD",293499,293481,294437,18,294455,294437,293481,18
"535","ECK0283-JW0278","yagR",TRUE,"paoC","paoC",294465,294447,296645,18,296663,296645,294447,18
"537","ECK0284-JW0279","yagS",TRUE,"paoB","paoB",296660,296642,297598,18,297616,297598,296642,18
"539","ECK0285-JW0280","yagT",TRUE,"paoA","paoA",297613,297595,298284,18,298302,298284,297595,18
"545","ECK0288-JW5030","yagV",TRUE,"ecpE","ecpE",300224,300206,300916,18,300979,300916,300206,63
"547","ECK0289-JW0284","yagW",TRUE,"ecpD","ecpD",300903,300885,302528,18,302546,302528,300885,18
"549","ECK0290-JW0285","yagX",TRUE,"ecpC","ecpC",302536,302518,305043,18,305061,305043,302518,18
"551","ECK0291-JW0286","yagY",TRUE,"ecpB","ecpB",305087,305069,305737,18,305755,305737,305069,18
"553","ECK0292-JW0287","yagZ",TRUE,"ecpA","ecpA",305813,305795,306382,18,306400,306382,305795,18
"555","ECK0293-JW5031","ykgK",TRUE,"matA","matA",306475,306457,306999,18,306726,306999,306457,-273
"557","none-JW5032","none",TRUE,"ykgL","ykgL",307651,307823,308050,-172,307761,308050,307823,-289
"561","ECK0295-JW5034","ykgM",TRUE,"ykgO","ykgO",308103,308085,308225,18,308243,308225,308085,18
"565","ECK0297-JW0291","eaeH",TRUE,"BW25113_RS01535","BW25113_RS01535",310068,310068,310943,0,310955,310943,310068,12
"567","ECK0300-JW5037","ykgA",TRUE,"BW25113_RS01550","BW25113_RS01550",312179,312194,312847,-15,312898,312847,312194,51
"569","ECK0301-JW5038","ykgB",TRUE,"rclC","rclC",313455,313437,314030,18,314057,314030,313437,27
"571","ECK0302-JW5039","ykgI",TRUE,"rclB","rclB",314060,314042,314278,18,314311,314278,314042,33
"573","ECK0303-JW5040","ykgC",TRUE,"rclA","rclA",314405,314387,315712,18,315730,315712,314387,18
"575","ECK0304-JW0298","ykgD",TRUE,"rclR","rclR",315938,315938,316792,0,316792,316792,315938,0
"593","ECK0313-JW0307","yahA",TRUE,"pdeL","pdeL",328082,328082,329170,0,329170,329170,328082,0
"669","none-JW5047","none",FALSE,"frmB","yaiL",372789,372991,373824,-202,372896,372767,372228,129
"679","ECK0356-JW0350","yaiX",TRUE,"BW25113_RS01855","BW25113_RS01855",376318,376300,376743,18,376533,376743,376300,-210
"681","ECK0359-JW5814","yaiF",TRUE,"BW25113_RS23340","BW25113_RS23340",377978,378044,378229,-66,378364,378229,378044,135
"685","ECK0361-JW0356","yaiS",TRUE,"BW25113_RS01880","BW25113_RS01880",379533,379401,380072,132,380090,380072,379401,18
"697","ECK0367-JW5049","ykiB",FALSE,"BW25113_RS01915","hemB",385371,385707,387167,-336,385589,385183,384209,406
"699","ECK0368-JW0362","yaiT",TRUE,"BW25113_RS01915","BW25113_RS01915",385707,385707,387167,0,387167,387167,385707,0
"701","ECK0369-JW5051","yaiU",TRUE,"BW25113_RS01930","BW25113_RS01930",388477,388432,389874,45,389874,389874,388432,0
"703","ECK0370-JW0366","yaiV",TRUE,"iprA","iprA",389917,389962,390585,-45,390585,390585,389962,0
"717","ECK0377-JW0373","yaiB",TRUE,"iraP","iraP",396842,396842,397102,0,397102,397102,396842,0
"723","ECK0380-JW0376","yaiC",TRUE,"dgcC","dgcC",399159,399159,400274,0,400274,400274,399159,0
"735","ECK0386-JW0382","yaiE",TRUE,"ppnP","ppnP",403633,403633,403917,0,403917,403917,403633,0
"737","ECK0387-JW0383","ykiA",TRUE,"BW25113_RS02035","BW25113_RS02035",404125,404065,404406,60,404406,404406,404065,0
"759","ECK0398-JW0394","yajB",TRUE,"acpH","acpH",419811,419793,420374,18,420392,420374,419793,18
"777","ECK0407-JW0403","ybaD",TRUE,"nrdR","nrdR",428458,428458,428907,0,428907,428907,428458,0
"837","ECK0437-JW0433","ybaW",TRUE,"fadM","fadM",459858,459858,460256,0,460256,460256,459858,0
"839","ECK0438-JW0434","ybaX",TRUE,"queC","queC",460326,460308,461003,18,461021,461003,460308,18
"845","ECK0441-JW0437","ybaO",TRUE,"decR","decR",463839,463839,464297,0,464297,464297,463839,0
"859","ECK0448-JW0444","ybaZ",TRUE,"BW25113_RS02350","BW25113_RS02350",471456,471438,471749,18,471845,471749,471438,96
"863","ECK0451-JW5062","ylaB",TRUE,"pdeB","pdeB",472541,472523,474073,18,474097,474073,472523,24
"871","ECK0455-JW0450","ybaJ",TRUE,"tomB","tomB",475808,475790,476164,18,476182,476164,475790,18
"879","ECK0459-JW0454","kefA",TRUE,"mscK","mscK",481992,481992,485354,0,485354,485354,481992,0
"909","none-JW5064","none",FALSE,"ushA","fsr",500188,500370,502022,-182,500373,500152,498932,221
"921","ECK0479-JW0474","ybaS",TRUE,"glsA","glsA",507097,507097,508029,0,508029,508029,507097,0
"929","ECK0483-JW0478","ybbK",TRUE,"qmcA","qmcA",510330,510312,511229,18,511247,511229,510312,18
"931","ECK0484-JW0479","ybbL",TRUE,"fetA","fetA",511375,511375,512052,0,512052,512052,511375,0
"933","ECK0485-JW5066","ybbM",TRUE,"fetB","fetB",512012,512039,512818,-27,512818,512818,512039,0
"935","ECK0486-JW5067","ybbN",TRUE,"cnoX","cnoX",512899,512881,513735,18,513789,513735,512881,54
"949","ECK0493-JW0488","ylbH",TRUE,"BW25113_RS02575","BW25113_RS02575",523405,523405,524115,0,524115,524115,523405,0
"951","ECK0494-JW0489","ybbD",TRUE,"BW25113_RS24960","BW25113_RS24960",524096,524096,524356,0,524356,524356,524096,0
"953","none-JW5068","none",TRUE,"ylbG","ylbG",524889,525107,525472,-218,525104,525472,525107,-368
"955","none-JW5069","none",TRUE,"ylbG","ylbG",525119,525107,525472,12,525490,525472,525107,18
"957","ECK0496-JW0491","ybbB",TRUE,"selU","selU",525606,525588,526682,18,526700,526682,525588,18
"959","ECK0497-JW0492","ybbS",TRUE,"allS","allS",526769,526751,527677,18,527695,527677,526751,18
"971","ECK0503-JW0498","ybbV",FALSE,"ybbW","glxR",532952,533089,534543,-137,533230,532920,532042,310
"981","ECK0508-JW0503","ylbA",TRUE,"allE","allE",538735,538717,539502,18,539520,539502,538717,18
"989","ECK0512-JW0507","ylbE",FALSE,"ylbE","fdrA",543813,543813,545072,0,544073,543803,542136,270
"1027","ECK0531-JW0526","ybcC",TRUE,"BW25113_RS02760","BW25113_RS02760",561572,561554,561832,18,561835,561832,561554,3
"1029","ECK0532-JW0527","ybcD",TRUE,"BW25113_RS02765","BW25113_RS02765",561907,561832,562143,75,562143,562143,561832,0
"1031","ECK0533-JW0530","renD",TRUE,"BW25113_RS02785","BW25113_RS02785",563518,563491,563703,27,563703,563703,563491,0
"1035","none-JW5075","none",TRUE,"ylcJ","ylcJ",564151,564151,564300,0,564300,564300,564151,0
"1053","ECK0543-JW0539","ybcQ",TRUE,"quuD","quuD",569412,569412,569795,0,569795,569795,569412,0
"1055","ECK0544-JW5078","nmpC",TRUE,"ompC","ompC",571232,571214,572281,18,572359,572281,571214,78
"1059","ECK0546-JW0544","ybcS",TRUE,"rrrD","rrrD",573069,573069,573566,0,573566,573566,573069,0
"1061","ECK0547-JW5079","rzpD",TRUE,"rzoD","rzoD",573551,573783,573965,-232,574024,573965,573783,59
"1071","ECK0552-JW0549","nohB",TRUE,"nohD","nohD",576290,576290,576835,0,576835,576835,576290,0
"1073","ECK0553-JW5815","tfaD",FALSE,"BW25113_RS25975","BW25113_RS25980",576810,576810,577118,0,577553,577553,577116,0
"1075","ECK0554-JW0551","ybcY",TRUE,"BW25113_RS02910","BW25113_RS02910",577626,577608,578234,18,578210,578234,577608,-24
"1077","ECK0555-JW0552","ylcE",TRUE,"BW25113_RS02915","BW25113_RS02915",578331,578331,578591,0,578516,578591,578331,-75
"1107","ECK0570-JW0567","nfnB",TRUE,"nfsB","nfsB",600245,600227,600880,18,600898,600880,600227,18
"1135","ECK0584-JW0583","ybdA",TRUE,"entS","entS",617756,617756,619006,0,619006,619006,617756,0
"1147","ECK0590-JW0589","ybdB",TRUE,"entH","entH",624756,624756,625169,0,625169,625169,624756,0
"1153","ECK0593-JW0592","ybdH",TRUE,"hcxA","hcxA",627863,627845,628933,18,628951,628933,627845,18
"1191","ECK0612-JW0611","citA",TRUE,"dpiB","dpiB",647691,647691,649349,0,649349,649349,647691,0
"1193","ECK0613-JW0612","citB",TRUE,"dpiA","dpiA",649318,649318,649998,0,649998,649998,649318,0
"1199","ECK0615-JW0617","crcA",TRUE,"pagP","pagP",652013,652013,652573,0,652573,652573,652013,0
"1205","ECK0618-JW0620","ybeH",FALSE,"BW25113_RS03250","crcB",653487,653487,654274,0,653714,653394,653011,320
"1207","ECK0619-JW0621","ybeM",TRUE,"BW25113_RS03250","BW25113_RS03250",653711,653487,654274,224,654274,654274,653487,0
"1227","ECK0629-JW0631","ybeA",TRUE,"rlmH","rlmH",663722,663704,664171,18,664189,664171,663704,18
"1229","ECK0630-JW5090","ybeB",TRUE,"rsfS","rsfS",664193,664175,664492,18,664402,664492,664175,-90
"1237","ECK0634-JW0636","rlpB",TRUE,"lptE","lptE",667079,667061,667642,18,667660,667642,667061,18
"1269","ECK0650-JW0655","ybeX",TRUE,"corC","corC",686380,686362,687240,18,687258,687240,686362,18
"1281","ECK0663-JW0661","nagD",TRUE,"umpH","umpH",695048,695030,695782,18,695800,695782,695030,18
"1293","ECK0669-JW0667","ybfM",TRUE,"chiP","chiP",703790,703790,705196,0,705196,705196,703790,0
"1295","ECK0670-JW0668","ybfN",TRUE,"chiQ","chiQ",705246,705246,705572,0,705572,705572,705246,0
"1299","none-JW0670","none",TRUE,"uof","uof",706147,706095,706181,52,706401,706181,706095,220
"1313","ECK0678-JW5094","ybfG",TRUE,"BW25113_RS03565","BW25113_RS03565",711421,711403,712053,18,711783,712053,711403,-270
"1315","ECK0679-JW5095","ybfH",FALSE,"BW25113_RS03570","BW25113_RS03565",711862,712177,712326,-315,712179,712053,711403,126
"1321","none-JW0681","none",TRUE,"BW25113_RS24990","BW25113_RS24990",716039,716039,716296,0,716296,716296,716039,0
"1341","ECK0691-JW0692","ybfO",TRUE,"BW25113_RS03635","BW25113_RS03635",729676,729604,731109,72,731109,731109,729604,0
"1347","ECK0694-JW0695","ybfL",TRUE,"BW25113_RS03650","BW25113_RS03650",732356,732281,733417,75,733417,733417,732281,0
"1355","ECK0698-JW0699","ybgH",TRUE,"dtpD","dtpD",736549,736531,738012,18,738030,738012,736531,18
"1359","ECK0700-JW0701","ybgJ",TRUE,"pxpB","pxpB",739049,739049,739705,0,739705,739705,739049,0
"1361","ECK0701-JW0702","ybgK",TRUE,"pxpC","pxpC",739699,739699,740631,0,740631,740631,739699,0
"1363","ECK0702-JW0703","ybgL",TRUE,"pxpA","pxpA",740621,740621,741355,0,741355,741355,740621,0
"1405","ECK0723-JW0724","ybgT",TRUE,"cydX","cydX",769652,769652,769765,0,769765,769765,769652,0
"1421","ECK0731-JW0732","ybgF",TRUE,"cpoB","cpoB",775054,775054,775845,0,775845,775845,775054,0
"1427","none-JW0735","none",TRUE,"zitB","zitB",779356,779338,780279,18,780297,780279,779338,18
"1429","ECK0741-JW5101","zitB",FALSE,"zitB","pnuC",779356,779338,780279,18,779646,779341,778622,305
"1449","ECK0751-JW5102","ybhT",TRUE,"acrZ","acrZ",790223,790229,790378,-6,790378,790378,790229,0
"1459","ECK0756-JW0750","ybhE",TRUE,"pgl","pgl",794042,794042,795037,0,795037,795037,794042,0
"1503","ECK0778-JW0772","ybhO",TRUE,"clsB","clsB",817972,817954,819195,18,819213,819195,817954,18
"1517","ECK0785-JW0780","ybiH",TRUE,"cecR","cecR",825446,825428,826099,18,826117,826099,825428,18
"1527","ECK0790-JW0786","ybiC",TRUE,"hcxB","hcxB",831807,831807,832892,0,832892,832892,831807,0
"1537","ECK0795-JW5106","ybiM",TRUE,"mcbA","mcbA",837270,837252,837512,18,837530,837512,837252,18
"1539","ECK0796-JW5107","ybiN",TRUE,"rlmF","rlmF",837707,837788,838714,-81,838714,838714,837788,0
"1555","ECK0804-JW0800","ybiP",TRUE,"opgE","opgE",846488,846470,848053,18,848071,848053,846470,18
"1561","ECK0809-JW0803","ybiS",TRUE,"ldtB","ldtB",850298,850280,851200,18,851218,851200,850280,18
"1581","ECK0819-JW5897","yliA",TRUE,"gsiA","gsiA",862958,862976,864847,-18,864847,864847,862976,0
"1583","ECK0820-JW5111","yliB",TRUE,"gsiB","gsiB",864867,864867,866405,0,866405,866405,864867,0
"1585","ECK0821-JW0815","yliC",TRUE,"gsiC","gsiC",866423,866423,867343,0,867343,867343,866423,0
"1587","ECK0822-JW0816","yliD",TRUE,"gsiD","gsiD",867346,867346,868257,0,868257,868257,867346,0
"1589","ECK0823-JW0817","yliE",TRUE,"pdeI","pdeI",868435,868435,870783,0,870783,870783,868435,0
"1591","ECK0824-JW0818","yliF",TRUE,"dgcI","dgcI",870791,870791,872119,0,872119,872119,870791,0
"1593","ECK0825-JW0819","yliG",TRUE,"rimO","rimO",872184,872166,873491,18,873509,873491,872166,18
"1595","ECK0826-JW0820","yliH",TRUE,"bssR","bssR",873704,873704,874087,0,874087,874087,873704,0
"1599","ECK0828-JW0822","yliJ",TRUE,"gstB","gstB",875328,875310,875936,18,875954,875936,875310,18
"1607","ECK0832-JW0826","cmr",TRUE,"mdfA","mdfA",879129,879129,880361,0,880361,880361,879129,0
"1615","ECK0836-JW5114","ybjK",TRUE,"rcdA","rcdA",882849,882879,883415,-30,883415,883415,882879,0
"1617","none-JW5115","none",FALSE,"ybjL","rcdA",883473,883590,885275,-117,883598,883415,882879,183
"1643","ECK0850-JW0843","rumB",TRUE,"rlmC","rlmC",893974,893974,895101,0,895101,895101,893974,0
"1659","ECK0858-JW0851","ybjR",TRUE,"amiD","amiD",900369,900369,901199,0,901199,901199,900369,0
"1673","ECK0865-JW0858","ybjE",TRUE,"lysO","lysO",909432,909414,910313,18,910331,910313,909414,18
"1707","ECK0883-JW0875","ycaJ",TRUE,"rarA","rarA",933450,933450,934793,0,934793,934793,933450,0
"1763","ECK0911-JW0903","ycbC",TRUE,"elyC","elyC",968096,968078,968857,18,968875,968857,968078,18
"1765","ECK0912-JW0904","smtA",TRUE,"cmoM","cmoM",968993,968993,969778,0,969778,969778,968993,0
"1773","ECK0916-JW0908","ycbB",TRUE,"ldtD","ldtD",976503,976503,978350,0,978350,978350,976503,0
"1775","ECK0917-JW0909","ycbK",TRUE,"mepK","mepK",978531,978531,979079,0,979079,979079,978531,0
"1777","ECK0918-JW0910","ycbL",TRUE,"gloC","gloC",979106,979106,979753,0,979753,979753,979106,0
"1799","ECK0929-JW5122","ycbQ",TRUE,"elfA","elfA",993324,993324,993863,0,993863,993863,993324,0
"1801","ECK0930-JW0922","ycbR",TRUE,"elfD","elfD",993946,993946,994647,0,994647,994647,993946,0
"1803","ECK0931-JW0923","ycbS",TRUE,"elfC","elfC",994672,994672,997272,0,997272,997272,994672,0
"1805","ECK0932-JW0924","ycbT",TRUE,"elfG","elfG",997263,997263,998333,0,998333,998333,997263,0
"1815","ECK0937-JW5125","ycbW",TRUE,"zapC","zapC",1001372,1001408,1001950,-36,1001950,1001950,1001408,0
"1819","ECK0939-JW0931","ycbY",TRUE,"rlmL","rlmL",1003300,1003300,1005408,0,1005408,1005408,1003300,0
"1827","ECK0943-JW5127","ymbA",TRUE,"pqiC","pqiC",1010352,1010352,1010915,0,1010915,1010915,1010352,0
"1835","ECK0947-JW0939","ycbG",TRUE,"matP","matP",1013941,1013941,1014393,0,1014393,1014393,1013941,0
"1841","ECK0950-JW0942","yccR",TRUE,"sxy","sxy",1016594,1016594,1017223,0,1017223,1017223,1016594,0
"1855","ECK0957-JW5970","yccV",TRUE,"hspQ","hspQ",1023878,1023860,1024177,18,1024246,1024177,1023860,69
"1857","ECK0958-JW5898","yccW",TRUE,"rlmI","rlmI",1024253,1024235,1025425,18,1025443,1025425,1024235,18
"1861","ECK0960-JW0952","yccK",TRUE,"tusE","tusE",1025813,1025795,1026124,18,1026142,1026124,1025795,18
"1881","none-JW0962","none",TRUE,"appX","appX",1035901,1035901,1035993,0,1035993,1035993,1035901,0
"1885","ECK0972-JW0964","yccC",TRUE,"etk","etk",1037504,1037486,1039666,18,1039684,1039666,1037486,18
"1889","ECK0974-JW0966","yccZ",TRUE,"gfcE","gfcE",1040138,1040120,1041259,18,1041277,1041259,1040120,18
"1891","ECK0975-JW0967","ymcA",TRUE,"gfcD","gfcD",1041323,1041305,1043401,18,1043419,1043401,1041305,18
"1893","ECK0976-JW0968","ymcB",TRUE,"gfcC","gfcC",1043419,1043401,1044147,18,1044165,1044147,1043401,18
"1895","ECK0977-JW0969","ymcC",TRUE,"gfcB","gfcB",1044162,1044144,1044788,18,1044806,1044788,1044144,18
"1897","ECK0978-JW5133","ymcD",TRUE,"gfcA","gfcA",1044913,1044895,1045200,18,1045236,1045200,1044895,36
"1935","ECK0997-JW5137","ycdG",TRUE,"rutG","rutG",1063985,1063967,1065295,18,1065379,1065295,1063967,84
"1937","ECK0998-JW5138","ycdH",TRUE,"rutF","rutF",1065334,1065316,1065810,18,1065909,1065810,1065316,99
"1939","ECK0999-JW0993","ycdI",TRUE,"rutE","rutE",1065839,1065821,1066411,18,1066429,1066411,1065821,18
"1941","ECK1000-JW0994","rarA",TRUE,"rutD","rutD",1066439,1066421,1067221,18,1067239,1067221,1066421,18
"1943","ECK1001-JW0995","ycdK",TRUE,"rutC","rutC",1067247,1067229,1067615,18,1067633,1067615,1067229,18
"1945","ECK1002-JW5139","ycdL",TRUE,"rutB","rutB",1067645,1067627,1068319,18,1068340,1068319,1067627,21
"1947","ECK1003-JW0997","ycdM",TRUE,"rutA","rutA",1068337,1068319,1069410,18,1069485,1069410,1068319,75
"1949","ECK1004-JW0998","ycdC",TRUE,"rutR","rutR",1069698,1069698,1070336,0,1070336,1070336,1069698,0
"1953","none-JW1000","none",TRUE,"BW25113_RS05280","BW25113_RS05280",1074508,1074393,1074602,115,1074699,1074602,1074393,97
"1957","none-JW5140","none",FALSE,"BW25113_RS05295","putP",1076492,1076812,1077641,-320,1076794,1076269,1074761,525
"1959","ECK1007-JW5141","ycdN",FALSE,"BW25113_RS05295","putP",1076812,1076812,1077641,0,1076922,1076269,1074761,653
"1961","ECK1007-JW1002","ycdN",TRUE,"BW25113_RS05295","BW25113_RS05295",1076910,1076812,1077641,98,1077641,1077641,1076812,0
"1963","ECK1008-JW1003","ycdO",TRUE,"efeO","efeO",1077699,1077699,1078826,0,1078826,1078826,1077699,0
"1965","ECK1009-JW1004","ycdB",TRUE,"efeB","efeB",1078832,1078832,1080103,0,1080103,1080103,1078832,0
"1969","ECK1011-JW1006","ycdP",TRUE,"pgaD","pgaD",1081580,1081562,1081975,18,1081993,1081975,1081562,18
"1971","ECK1012-JW1007","ycdQ",TRUE,"pgaC","pgaC",1081995,1081977,1083302,18,1083320,1083302,1081977,18
"1973","ECK1013-JW5142","ycdR",FALSE,"pgaB","pgaC",1083313,1083295,1085313,18,1083624,1083302,1081977,322
"1975","ECK1014-JW1010","ycdS",TRUE,"pgaA","pgaA",1085340,1085322,1087745,18,1087763,1087745,1085322,18
"1977","ECK1015-JW5143","ycdT",TRUE,"dgcT","dgcT",1088332,1088332,1089690,0,1089690,1089690,1088332,0
"1979","ECK1016-JW5145","ymdE",TRUE,"BW25113_RS05355","BW25113_RS05355",1091000,1090961,1091302,39,1091302,1091302,1090961,0
"1983","ECK1019-JW5146","ycdW",TRUE,"ghrA","ghrA",1093342,1093342,1094280,0,1094280,1094280,1093342,0
"1999","none-JW5148","none",TRUE,"csgB","csgB",1099137,1099407,1099862,-270,1099322,1099862,1099407,-540
"2011","ECK1032-JW5150","ymdC",TRUE,"clsC","clsC",1101811,1101751,1103232,60,1103232,1103232,1101751,0
"2013","ECK1033-JW1034","mdoC",TRUE,"opgC","opgC",1103258,1103240,1104397,18,1104415,1104397,1103240,18
"2015","ECK1034-JW1035","mdoG",TRUE,"opgG","opgG",1104791,1104791,1106326,0,1106326,1106326,1104791,0
"2017","ECK1035-JW1037","mdoH",TRUE,"opgH","opgH",1106319,1106319,1108862,0,1108862,1108862,1106319,0
"2027","ECK1040-JW1042","yceA",TRUE,"trhO","trhO",1112263,1112263,1113315,0,1113315,1113315,1112263,0
"2033","ECK1043-JW1045","yceO",TRUE,"BW25113_RS05515","BW25113_RS05515",1114781,1114763,1114876,18,1114921,1114876,1114763,45
"2037","ECK1045-JW5152","yceP",TRUE,"bssS","bssS",1116175,1116157,1116411,18,1116432,1116411,1116157,21
"2053","ECK1053-JW1055","mviM",TRUE,"yceM","yceM",1122262,1122262,1123185,0,1123185,1123185,1122262,0
"2055","ECK1054-JW1056","mviN",TRUE,"murJ","murJ",1123295,1123295,1124830,0,1124830,1124830,1123295,0
"2087","ECK1070-JW5154","yceQ",FALSE,"rluC","rne",1139958,1140396,1141355,-438,1140278,1139823,1136638,455
"2111","ECK1083-JW1083","yceG",TRUE,"mltG","mltG",1149568,1149568,1150590,0,1150590,1150590,1149568,0
"2127","ECK1091-JW5157","ycfM",TRUE,"lpoB","lpoB",1158091,1158094,1158735,-3,1158735,1158735,1158094,0
"2129","ECK1092-JW1092","ycfN",TRUE,"thiK","thiK",1158716,1158716,1159540,0,1159540,1159540,1158716,0
"2139","ECK1097-JW5159","ycfQ",TRUE,"comR","comR",1163674,1163656,1164288,18,1164384,1164288,1163656,96
"2141","ECK1098-JW1098","ycfR",TRUE,"bhsA","bhsA",1164529,1164529,1164786,0,1164786,1164786,1164529,0
"2143","ECK1099-JW5820","ycfS",TRUE,"ldtC","ldtC",1164886,1164868,1165830,18,1165848,1165830,1164868,18
"2155","ECK1105-JW1105","ycfX",TRUE,"nagK","nagK",1174049,1174049,1174960,0,1174960,1174960,1174049,0
"2159","none-JW5163","none",FALSE,"ycfZ","cobB",1175810,1175935,1176723,-125,1175938,1175815,1174976,123
"2175","ECK1114-JW1114","ycfD",TRUE,"roxA","roxA",1182593,1182575,1183696,18,1183714,1183696,1182575,18
"2185","ECK1119-JW1119","trmU",TRUE,"mnmA","mnmA",1188141,1188123,1189229,18,1189247,1189229,1188123,18
"2187","ECK1120-JW1120","ymfB",TRUE,"nudJ","nudJ",1189301,1189283,1189744,18,1189762,1189744,1189283,18
"2189","ECK1121-JW1121","ymfC",TRUE,"rluE","rluE",1189772,1189754,1190407,18,1190425,1190407,1189754,18
"2197","none-JW5167","none",FALSE,"lit","ymfE",1193983,1194151,1195044,-168,1194093,1193693,1192989,400
"2203","ECK1127-JW1127","ymfG",TRUE,"xisE","xisE",1196261,1196243,1196488,18,1196506,1196488,1196243,18
"2217","ECK1134-JW1134","ymfM",TRUE,"BW25113_RS23635","BW25113_RS23635",1199278,1199457,1199636,-179,1199616,1199636,1199457,-20
"2223","ECK1137-JW1137","ymfO",TRUE,"BW25113_RS05975","BW25113_RS05975",1201187,1201187,1201594,0,1201660,1201594,1201187,66
"2225","ECK1138-JW5170","ymfP",TRUE,"BW25113_RS05980","BW25113_RS05980",1201548,1201587,1202378,-39,1202378,1202378,1201587,0
"2231","ECK1141-JW5171","ymfS",TRUE,"tfaP","tfaP",1203588,1203588,1204001,0,1204001,1204001,1203588,0
"2235","ECK1143-JW5172","stfE",TRUE,"BW25113_RS06005","BW25113_RS06005",1204593,1204575,1205069,18,1205132,1205069,1204575,63
"2237","ECK1144-JW1144","pin",TRUE,"pinE","pinE",1205141,1205141,1205695,0,1205695,1205695,1205141,0
"2241","ECK1146-JW5173","icdC",TRUE,"BW25113_RS23640","BW25113_RS23640",1206869,1206866,1207033,3,1207033,1207033,1206866,0
"2243","ECK1147-JW1147","elbA",TRUE,"iraM","iraM",1207154,1207136,1207459,18,1207477,1207459,1207136,18
"2247","ECK1149-JW1149","ycgE",TRUE,"bluR","bluR",1208802,1208784,1209515,18,1209533,1209515,1208784,18
"2249","ECK1150-JW1150","ycgF",TRUE,"bluF","bluF",1209738,1209720,1210931,18,1210949,1210931,1209720,18
"2255","ECK1153-JW1153","ymgB",TRUE,"ariR","ariR",1211825,1211825,1212091,0,1212091,1212091,1211825,0
"2259","ECK1155-JW5174","ycgG",TRUE,"pdeG","pdeG",1212742,1212784,1214307,-42,1214307,1214307,1212784,0
"2263","ECK1157-JW5901","ycgH",TRUE,"BW25113_RS25990","BW25113_RS25990",1215057,1215057,1217704,0,1216577,1217704,1215057,-1127
"2265","ECK1157-JW5176","ycgH",FALSE,"ymgD","BW25113_RS25990",1216644,1217761,1218096,-1117,1217677,1217704,1215057,-27
"2271","ECK1160-JW5179","ymgH",FALSE,"BW25113_RS06105","BW25113_RS25540",1218954,1219020,1219363,-66,1219142,1218985,1218866,157
"2273","ECK1161-JW1162","ycgI",TRUE,"BW25113_RS06105","BW25113_RS06105",1219151,1219020,1219363,131,1219363,1219363,1219020,0
"2283","ECK1166-JW1167","ycgK",TRUE,"pliG","pliG",1222545,1222527,1222928,18,1222946,1222928,1222527,18
"2285","ECK1167-JW1168","ycgL",TRUE,"BW25113_RS06140","BW25113_RS06140",1223137,1223170,1223463,-33,1223463,1223463,1223170,0
"2309","none-JW5183","none",FALSE,"cvrA","dadX",1235508,1235791,1237527,-283,1235657,1235405,1234335,252
"2325","ECK1186-JW5185","dhaH",TRUE,"dhaM","dhaM",1243170,1243152,1244570,18,1244588,1244570,1243152,18
"2341","ECK1194-JW5189","ychM",TRUE,"dauA","dauA",1254598,1254580,1256259,18,1255923,1256259,1254580,-336
"2343","ECK1195-JW1198","prsA",TRUE,"prs","prs",1256402,1256384,1257331,18,1257349,1257331,1256384,18
"2369","ECK1214-JW1211","ychP",TRUE,"ychO","ychO",1269381,1269240,1270634,141,1270634,1270634,1269240,0
"2375","none-JW5190","none",FALSE,"narK","narX",1273100,1273413,1274804,-313,1273318,1273074,1271278,244
"2387","none-JW5191","none",FALSE,"BW25113_RS23090","BW25113_RS23095",1282340,1282344,1282475,-4,1282693,1282653,1282522,40
"2389","ECK1224-JW1219","tpr",TRUE,"BW25113_RS23095","BW25113_RS23095",1282561,1282522,1282653,39,1282662,1282653,1282522,9
"2423","ECK1243-JW1241","cls",TRUE,"clsA","clsA",1301460,1301442,1302902,18,1302920,1302902,1301442,18
"2425","none-JW5194","none",TRUE,"yciY","yciY",1303012,1303045,1303218,-33,1303218,1303218,1303045,0
"2459","ECK1260-JW1258","yciV",TRUE,"rnm","rnm",1317477,1317477,1318358,0,1318358,1318358,1317477,0
"2479","ECK1270-JW5198","yciX",TRUE,"BW25113_RS06655","BW25113_RS06655",1329417,1329381,1329545,36,1329545,1329545,1329381,0
"2489","ECK1274-JW1271","yciS",TRUE,"lapA","lapA",1334500,1334500,1334808,0,1334808,1334808,1334500,0
"2491","ECK1275-JW1272","yciM",TRUE,"lapB","lapB",1334815,1334815,1335984,0,1335984,1335984,1334815,0
"2501","ECK1280-JW1278","gmr",TRUE,"pdeR","pdeR",1339032,1339014,1340999,18,1341017,1340999,1339014,18
"2567","ECK1313-JW1311","ycjV",TRUE,"BW25113_RS06905","BW25113_RS06905",1375078,1375078,1376159,0,1376046,1376159,1375078,-113
"2569","ECK1314-JW5203","ymjB",FALSE,"ompG","BW25113_RS06905",1376046,1376204,1377109,-158,1376159,1376159,1375078,0
"2587","ECK1323-JW5960","ymjC",TRUE,"BW25113_RS06950","BW25113_RS06950",1384955,1384982,1385119,-27,1385137,1385119,1384982,18
"2591","ECK1325-JW1321","ycjZ",TRUE,"pgrR","pgrR",1386248,1386248,1387147,0,1387147,1387147,1386248,0
"2613","ECK1337-JW1334","ydaL",TRUE,"smrA","smrA",1400236,1400236,1400799,0,1400799,1400799,1400236,0
"2615","ECK1338-JW5206","ydaM",TRUE,"dgcM","dgcM",1400838,1400820,1402052,18,1402130,1402052,1400820,78
"2617","ECK1339-JW1336","ydaN",TRUE,"zntB","zntB",1402307,1402307,1403290,0,1403290,1403290,1402307,0
"2621","ECK1341-JW1338","ydaO",TRUE,"ttcA","ttcA",1405288,1405270,1406205,18,1406223,1406205,1405270,18
"2625","ECK1343-JW5207","ydaQ",TRUE,"xisR","xisR",1407512,1407494,1407709,18,1407751,1407709,1407494,42
"2627","ECK1344-JW1341","ydaC",TRUE,"rcbA","rcbA",1407806,1407788,1407997,18,1408015,1407997,1407788,18
"2629","ECK1345-JW5208","lar",TRUE,"ralR","ralR",1408008,1407990,1408184,18,1408202,1408184,1407990,18
"2639","ECK1350-JW1347","kil",TRUE,"kilR","kilR",1412283,1412265,1412486,18,1412504,1412486,1412265,18
"2645","ECK1353-JW5210","ydaG",TRUE,"ydaF","ydaF",1413597,1413413,1413568,184,1413776,1413568,1413413,208
"2657","ECK1359-JW5211","ydaW",TRUE,"BW25113_RS07140","BW25113_RS07140",1416958,1417009,1417461,-51,1417569,1417461,1417009,108
"2659","ECK1360-JW5212","rzpR",TRUE,"rzoR","rzoR",1417596,1417657,1417842,-61,1417901,1417842,1417657,59
"2671","ECK1366-JW5904","lomR",TRUE,"BW25113_RS25065","BW25113_RS25065",1422780,1423053,1423241,-273,1423241,1423241,1423053,0
"2676","ECK1368-JW1367","tfaR",TRUE,"tfaQ","tfaQ",1628585,1628567,1629142,18,1629160,1629142,1628567,18
"2705","ECK1384-JW1382","maoC",TRUE,"paaZ","paaZ",1445872,1445854,1447899,18,1447917,1447899,1445854,18
"2733","ECK1398-JW5802","ydbA",TRUE,"BW25113_RS07350","BW25113_RS07350",1459649,1459649,1462174,0,1462207,1462174,1459649,33
"2735","ECK1398-JW1402","ydbA",TRUE,"BW25113_RS07370","BW25113_RS07370",1464947,1464773,1468270,174,1468270,1468270,1464773,0
"2737","ECK1399-JW1403","ydbC",TRUE,"pdxI","pdxI",1468478,1468478,1469338,0,1469338,1469338,1468478,0
"2757","ECK1409-JW1413","gapC",FALSE,"gap","aldA",1483988,1483970,1484970,18,1484239,1483928,1482489,311
"2759","ECK1409-JW5906","gapC",TRUE,"gap","gap",1484236,1483970,1484970,266,1484640,1484970,1483970,-330
"2773","ECK1418-JW1420","mdoD",TRUE,"opgD","opgD",1491143,1491113,1492768,30,1492768,1492768,1491113,0
"2787","ECK1425-JW5227","yncK",FALSE,"tnpA","ydcL",1497418,1497400,1497906,18,1497585,1497382,1496714,203
"2789","ECK1425-JW5961","yncK",TRUE,"tnpA","tnpA",1497637,1497400,1497906,237,1497924,1497906,1497400,18
"2791","ECK1426-JW5228","ydcM",TRUE,"insQ","insQ",1497974,1497914,1499122,60,1499122,1499122,1497914,0
"2795","ECK1428-JW1430","ydcN",TRUE,"sutR","sutR",1500429,1500429,1500965,0,1500965,1500965,1500429,0
"2797","ECK1429-JW1431","ydcP",TRUE,"rlhA","rlhA",1501038,1501038,1502999,0,1502999,1502999,1501038,0
"2801","ECK1431-JW5230","yncN",TRUE,"hicA","hicA",1503543,1503543,1503719,0,1503719,1503719,1503543,0
"2803","ECK1432-JW1433","ydcQ",TRUE,"hicB","hicB",1503744,1503765,1504181,-21,1504181,1504181,1503765,0
"2815","ECK1438-JW1439","ydcW",TRUE,"patD","patD",1509835,1509835,1511259,0,1511259,1511259,1509835,0
"2817","none-JW5231","none",TRUE,"yncL","yncL",1511290,1511356,1511451,-66,1511487,1511451,1511356,36
"2819","ECK1439-JW5232","ydcX",TRUE,"ortT","ortT",1511571,1511646,1511819,-75,1511819,1511819,1511646,0
"2825","ECK1442-JW5233","yncA",TRUE,"mnaT","mnaT",1512603,1512585,1513103,18,1513121,1513103,1512585,18
"2827","ECK1443-JW5907","yncB",TRUE,"curA","curA",1513260,1513284,1514321,-24,1514321,1514321,1513284,0
"2829","ECK1444-JW1445","yncC",TRUE,"mcbR","mcbR",1514519,1514519,1515184,0,1515184,1515184,1514519,0
"2841","none-JW5236","none",FALSE,"BW25113_RS07645","yncH",1521834,1522159,1524195,-325,1521947,1521409,1521197,538
"2843","ECK1450-JW1451","rhsE",TRUE,"BW25113_RS07645","BW25113_RS07645",1522147,1522159,1524195,-12,1524195,1524195,1522159,0
"2847","ECK1452-JW1453","yncI",TRUE,"BW25113_RS07655","BW25113_RS07655",1524843,1524843,1525987,0,1525589,1525987,1524843,-398
"2849","ECK1453-JW5237","yncM",FALSE,"ydcC","BW25113_RS07655",1525708,1526073,1527209,-365,1525833,1525987,1524843,-154
"2853","ECK1455-JW1456","ydcE",TRUE,"pptA","pptA",1527309,1527309,1527542,0,1527542,1527542,1527309,0
"2865","ECK1461-JW1462","narY",TRUE,"narH","narH",1531584,1531566,1533110,18,1533128,1533110,1531566,18
"2871","ECK1464-JW1466","yddJ",FALSE,"BW25113_RS07710","narU",1538659,1538641,1539971,18,1538994,1538317,1536929,677
"2873","ECK1465-JW1467","yddK",TRUE,"BW25113_RS07710","BW25113_RS07710",1539033,1538641,1539971,392,1539989,1539971,1538641,18
"2889","ECK1473-JW5238","sfcA",TRUE,"maeA","maeA",1548247,1548229,1549926,18,1549971,1549926,1548229,45
"2909","ECK1483-JW1484","dos",TRUE,"dosP","dosP",1557609,1557591,1559990,18,1560008,1559990,1557591,18
"2911","ECK1484-JW5241","yddV",TRUE,"dosC","dosC",1560033,1560015,1561397,18,1561415,1561397,1560015,18
"2913","ECK1485-JW1486","yddW",TRUE,"digH","digH",1561779,1561761,1563080,18,1563098,1563080,1561761,18
"2941","ECK1499-JW5244","yneL",TRUE,"BW25113_RS07895","BW25113_RS07895",1584632,1584591,1584799,41,1584811,1584799,1584591,12
"2947","ECK1502-JW1502","ydeU",TRUE,"BW25113_RS07910","BW25113_RS07910",1586940,1586922,1588322,18,1588340,1588322,1586922,18
"2949","ECK1503-JW1503","ydeK",TRUE,"BW25113_RS07915","BW25113_RS07915",1588384,1588319,1592343,65,1592361,1592343,1588319,18
"2951","ECK1504-JW1504","ydeV",TRUE,"lsrK","lsrK",1592892,1592874,1594466,18,1594484,1594466,1592874,18
"2953","ECK1505-JW1505","ydeW",TRUE,"lsrR","lsrR",1594563,1594545,1595498,18,1595516,1595498,1594545,18
"2955","ECK1506-JW1506","ego",TRUE,"lsrA","lsrA",1595747,1595747,1597282,0,1597282,1597282,1595747,0
"2973","ECK1515-JW5825","yneF",TRUE,"dgcF","dgcF",1605182,1605164,1606150,18,1606081,1606150,1605164,-69
"2977","ECK1517-JW1517","yneH",TRUE,"glsB","glsB",1606600,1606582,1607508,18,1607526,1607508,1606582,18
"2979","ECK1518-JW5247","yneI",TRUE,"sad","sad",1607590,1607572,1608960,18,1609002,1608960,1607572,42
"2999","ECK1528-JW1528","ydeH",TRUE,"dgcZ","dgcZ",1617235,1617217,1618107,18,1618125,1618107,1617217,18
"3009","ECK1533-JW1533","ydfH",TRUE,"rspR","rspR",1622609,1622609,1623295,0,1623295,1623295,1622609,0
"3022","ECK1539-JW1539","tfaQ",TRUE,"tfaR","tfaR",1426668,1426668,1427243,0,1427243,1427243,1426668,0
"3037","ECK1547-JW1545","ydfP",TRUE,"rzpQ","rzpQ",1633305,1633287,1633784,18,1633802,1633784,1633287,18
"3039","ECK1548-JW1546","ydfQ",TRUE,"rrrQ","rrrQ",1633799,1633781,1634314,18,1634332,1634314,1633781,18
"3067","ECK1562-JW1560","ydfX",TRUE,"BW25113_RS08215","BW25113_RS08215",1641621,1641615,1641893,6,1641911,1641893,1641615,18
"3075","ECK1566-JW1564","ydfB",TRUE,"ydfA","ydfA",1642922,1642765,1642920,157,1643050,1642920,1642765,130
"3083","ECK1571-JW1568","ydfE",TRUE,"BW25113_RS23850","BW25113_RS23850",1644335,1644335,1645102,0,1645255,1645102,1644335,153
"3085","ECK1573-JW1571","intQ",TRUE,"BW25113_RS25635","BW25113_RS25635",1645769,1645808,1646965,-39,1646965,1646965,1645808,0
"3115","ECK1588-JW5264","ynfK",TRUE,"bidA","bidA",1660799,1660781,1661476,18,1661494,1661476,1660781,18
"3117","ECK1589-JW1586","dgsA",TRUE,"mlc","mlc",1661619,1661601,1662821,18,1662839,1662821,1661601,18
"3131","ECK1596-JW1593","ydgG",TRUE,"tqsA","tqsA",1668170,1668170,1669204,0,1669204,1669204,1668170,0
"3181","ECK1621-JW1617","ydgT",TRUE,"cnu","cnu",1699206,1699206,1699421,0,1699421,1699421,1699206,0
"3199","none-JW5266","none",FALSE,"dtpA","nth",1706543,1707026,1708528,-483,1706743,1706415,1705780,328
"3201","ECK1630-JW1626","ydgR",TRUE,"dtpA","dtpA",1707026,1707026,1708528,0,1708528,1708528,1707026,0
"3203","ECK1631-JW1627","gst",TRUE,"gstA","gstA",1708634,1708634,1709239,0,1709239,1709239,1708634,0
"3211","ECK1635-JW1631","ydhA",TRUE,"mliC","mliC",1712341,1712323,1712652,18,1712670,1712652,1712323,18
"3213","ECK1636-JW1632","ydhH",TRUE,"anmK","anmK",1712768,1712750,1713859,18,1713877,1713859,1712750,18
"3231","ECK1645-JW5874","ydhM",TRUE,"nemR","nemR",1720364,1720280,1720879,84,1720879,1720879,1720280,0
"3241","ECK1650-JW1646","ydhD",TRUE,"grxD","grxD",1728029,1728011,1728358,18,1728376,1728358,1728011,18
"3243","ECK1651-JW5270","ydhO",TRUE,"mepH","mepH",1728761,1728692,1729507,69,1729507,1729507,1728692,0
"3251","ECK1655-JW1651","ydhB",TRUE,"punR","punR",1733141,1733123,1734055,18,1734073,1734055,1733123,18
"3253","ECK1656-JW1652","ydhC",TRUE,"punC","punC",1734168,1734168,1735379,0,1735379,1735379,1734168,0
"3279","ECK1671-JW1665","ydhZ",TRUE,"fumD","fumD",1749207,1749189,1749398,18,1749416,1749398,1749189,18
"3285","ECK1674-JW1668","ynhG",TRUE,"ldtE","ldtE",1751996,1751978,1752982,18,1753000,1752982,1751978,18
"3301","ECK1683-JW1676","ydiI",TRUE,"menI","menI",1759497,1759479,1759889,18,1759907,1759889,1759479,18
"3331","ECK1699-JW5910","ydiD",TRUE,"fadK","fadK",1777234,1777288,1778934,-54,1778934,1778934,1777288,0
"3333","ECK1700-JW1692","pps",TRUE,"ppsA","ppsA",1779009,1778991,1781369,18,1781387,1781369,1778991,18
"3335","ECK1701-JW1693","ydiA",TRUE,"ppsR","ppsR",1781702,1781702,1782535,0,1782535,1782535,1781702,0
"3341","ECK1704-JW1696","ydiU",TRUE,"selO","selO",1784083,1784065,1785501,18,1785519,1785501,1784065,18
"3343","ECK1705-JW1697","ydiV",TRUE,"rflP","rflP",1785582,1785564,1786277,18,1786295,1786277,1785564,18
"3369","ECK1718-JW5278","arpB",FALSE,"espL1","thrS",1797351,1797351,1799250,0,1797824,1796827,1794899,997
"3371","ECK1718-JW1710","arpB",TRUE,"espL1","espL1",1797835,1797351,1799250,484,1799250,1799250,1797351,0
"3385","ECK1725-JW1716","yniC",TRUE,"hxpB","hxpB",1803637,1803637,1804305,0,1804305,1804305,1803637,0
"3389","ECK1727-JW1718","ydjN",TRUE,"tcyP","tcyP",1805191,1805191,1806582,0,1806582,1806582,1805191,0
"3413","ECK1739-JW1730","ydjQ",TRUE,"cho","cho",1817772,1817772,1818659,0,1818659,1818659,1817772,0
"3415","ECK1740-JW1731","ydjR",TRUE,"ves","ves",1818637,1818619,1819194,18,1819212,1819194,1818619,18
"3487","ECK1776-JW1767","yeaA",TRUE,"msrB","msrB",1856291,1856273,1856686,18,1856704,1856686,1856273,18
"3501","ECK1783-JW1774","yeaI",TRUE,"cdgI","cdgI",1864642,1864642,1866117,0,1866117,1866117,1864642,0
"3503","ECK1784-JW5291","yeaJ",TRUE,"dgcJ","dgcJ",1866118,1866298,1867788,-180,1867788,1867788,1866298,0
"3509","ECK1788-JW1779","yeaM",TRUE,"nimR","nimR",1869030,1869012,1869833,18,1869851,1869833,1869012,18
"3511","ECK1789-JW1780","yeaN",TRUE,"nimT","nimT",1869930,1869930,1871111,0,1871111,1871111,1869930,0
"3517","ECK1792-JW5292","yeaP",TRUE,"dgcP","dgcP",1871972,1871972,1872997,0,1872997,1872997,1871972,0
"3525","ECK1796-JW1787","yeaS",TRUE,"leuE","leuE",1874396,1874378,1875016,18,1875034,1875016,1874378,18
"3527","ECK1797-JW1788","yeaT",TRUE,"dmlR","dmlR",1875161,1875143,1876066,18,1876084,1876066,1875143,18
"3529","ECK1798-JW1789","yeaU",TRUE,"dmlA","dmlA",1876169,1876169,1877254,0,1877254,1877254,1876169,0
"3543","ECK1805-JW1796","yeaZ",TRUE,"tsaB","tsaB",1884847,1884829,1885524,18,1885542,1885524,1884829,18
"3555","ECK1811-JW1802","yeaB",TRUE,"nudL","nudL",1890427,1890427,1891005,0,1891005,1891005,1890427,0
"3559","ECK1813-JW1804","yoaD",TRUE,"pdeD","pdeD",1892684,1892684,1894282,0,1894282,1894282,1892684,0
"3571","ECK1819-JW5830","yebN",TRUE,"mntP","mntP",1899891,1899945,1900511,-54,1900511,1900511,1899945,0
"3573","ECK1820-JW1811","rrmA",TRUE,"rlmA","rlmA",1900526,1900508,1901317,18,1901335,1901317,1900508,18
"3581","ECK1824-JW1815","yobG",TRUE,"mgrB","mgrB",1902898,1902880,1903023,18,1903041,1903023,1902880,18
"3595","ECK1831-JW1821","yebR",TRUE,"msrC","msrC",1909906,1909888,1910385,18,1910457,1910385,1909888,72
"3597","ECK1832-JW1822","yebS",TRUE,"letA","letA",1910515,1910515,1911798,0,1911798,1911798,1910515,0
"3599","ECK1833-JW1823","yebT",TRUE,"letB","letB",1911767,1911767,1914400,0,1914400,1914400,1911767,0
"3601","ECK1834-JW5301","yebU",TRUE,"rsmF","rsmF",1914474,1914480,1915919,-6,1915919,1915919,1914480,0
"3643","ECK1857-JW5304","yebA",TRUE,"mepM","mepM",1934588,1934570,1935892,18,1935847,1935892,1934570,-45
"3655","none-JW5305","none",TRUE,"yobI","yobI",1940234,1940372,1940437,-138,1940341,1940437,1940372,-96
"3657","ECK1863-JW5306","yebB",FALSE,"yobI","yebB",1940409,1940372,1940437,37,1941110,1941110,1940508,0
"3673","ECK1871-JW1859","yecO",TRUE,"cmoA","cmoA",1946959,1946959,1947702,0,1947702,1947702,1946959,0
"3675","ECK1872-JW1860","yecP",TRUE,"cmoB","cmoB",1947699,1947699,1948670,0,1948670,1948670,1947699,0
"3683","ECK1876-JW5309","yecM",FALSE,"yecM","cutC",1953555,1953537,1954103,18,1953689,1953523,1952777,166
"3719","ECK1894-JW1884","yecG",TRUE,"uspC","uspC",1973234,1973234,1973662,0,1973662,1973662,1973234,0
"3731","ECK1900-JW1890","yecI",TRUE,"ftnB","ftnB",1980406,1980406,1980909,0,1980909,1980909,1980406,0
"3737","ECK1904-JW1893","ftn",TRUE,"ftnA","ftnA",1982197,1982197,1982694,0,1982694,1982694,1982197,0
"3755","ECK1916-JW1902","yecC",TRUE,"tcyN","tcyN",1990561,1990543,1991295,18,1991313,1991295,1990543,18
"3757","ECK1917-JW1903","yecS",TRUE,"tcyL","tcyL",1991310,1991292,1991960,18,1991978,1991960,1991292,18
"3759","ECK1918-JW5313","yedO",TRUE,"dcyD","dcyD",1991993,1991975,1992961,18,1992979,1992961,1991975,18
"3761","ECK1919-JW1905","fliY",TRUE,"tcyJ","tcyJ",1993084,1993066,1993866,18,1993884,1993866,1993066,18
"3787","ECK1932-JW1918","yedN",TRUE,"BW25113_RS25135","BW25113_RS25135",2004847,2004829,2005020,18,2005038,2005020,2004829,18
"3789","ECK1932-JW5912","yedN",FALSE,"BW25113_RS10120","BW25113_RS25135",2005048,2005030,2005832,18,2005368,2005020,2004829,348
"3791","ECK1933-JW1920","yedM",TRUE,"BW25113_RS10120","BW25113_RS10120",2005500,2005030,2005832,470,2005850,2005832,2005030,18
"3793","ECK1934-JW5913","intG",TRUE,"fliE","fliE",2006019,2006181,2006495,-162,2006261,2006495,2006181,-234
"3831","ECK1954-JW5832","yedQ",TRUE,"dgcQ","dgcQ",2019822,2019804,2021498,18,2021516,2021498,2019804,18
"3847","ECK1962-JW5319","yedS",TRUE,"ompC","ompC",2027532,2027532,2028724,0,2028017,2028724,2027532,-707
"3849","ECK1962-JW1948","yedS",TRUE,"ompC","ompC",2028027,2027532,2028724,495,2028236,2028724,2027532,-488
"3851","ECK1962-JW1949","yedS",TRUE,"ompC","ompC",2028320,2027532,2028724,788,2028724,2028724,2027532,0
"3853","none-JW5320","none",FALSE,"hchA","ompC",2028743,2029316,2030167,-573,2028910,2028724,2027532,186
"3855","none-JW5321","none",FALSE,"hchA","ompC",2028951,2029316,2030167,-365,2029187,2028724,2027532,463
"3859","ECK1964-JW1951","yedV",TRUE,"hprS","hprS",2030293,2030275,2031633,18,2031651,2031633,2030275,18
"3861","ECK1965-JW5322","yedW",TRUE,"hprR","hprR",2031651,2031633,2032304,18,2032433,2032304,2031633,129
"3863","ECK1966-JW1953","yedX",TRUE,"hiuH","hiuH",2032437,2032437,2032850,0,2032850,2032850,2032437,0
"3865","ECK1967-JW1954","yedY",TRUE,"msrP","msrP",2032959,2032959,2033963,0,2033963,2033963,2032959,0
"3867","ECK1968-JW1955","yedZ",TRUE,"msrQ","msrQ",2033964,2033964,2034599,0,2034599,2034599,2033964,0
"3869","ECK1969-JW1956","yodA",TRUE,"zinT","zinT",2034856,2034856,2035506,0,2035506,2035506,2034856,0
"3873","ECK1972-JW1958","yeeI",TRUE,"mtfA","mtfA",2037132,2037132,2037929,0,2037929,2037929,2037132,0
"3877","ECK1975-JW5325","yeeL",FALSE,"BW25113_RS10340","yeeJ",2045775,2045757,2046809,18,2046101,2045495,2038419,606
"3879","ECK1975-JW1961","yeeL",TRUE,"BW25113_RS10340","BW25113_RS10340",2046123,2045757,2046809,366,2046827,2046809,2045757,18
"3893","ECK1985-JW1968","erfK",TRUE,"ldtA","ldtA",2055890,2055872,2056807,18,2056822,2056807,2055872,15
"3901","ECK1989-JW5326","yoeA",TRUE,"BW25113_RS24005","BW25113_RS24005",2062104,2062116,2062421,-12,2062508,2062421,2062116,87
"3903","ECK1990-JW1980","yoeE",TRUE,"BW25113_RS10435","BW25113_RS10435",2063725,2063755,2063952,-30,2063985,2063952,2063755,33
"3905","ECK1991-JW5327","yeeP",TRUE,"BW25113_RS10440","BW25113_RS10440",2064267,2063982,2064692,285,2064692,2064692,2063982,0
"3915","ECK1997-JW1986","yeeU",TRUE,"cbeA","cbeA",2070593,2070593,2070961,0,2070961,2070961,2070593,0
"3917","ECK1998-JW1987","yeeV",TRUE,"cbtA","cbtA",2071050,2071050,2071424,0,2071424,2071424,2071050,0
"3921","ECK2000-JW5328","yoeF",FALSE,"BW25113_RS24015","BW25113_RS10485",2072056,2072030,2072158,26,2072412,2072412,2072230,0
"3923","ECK2001-JW1989","yeeX",TRUE,"tmaR","tmaR",2072531,2072513,2072842,18,2072926,2072842,2072513,84
"3933","ECK2006-JW1994","yeeD",TRUE,"tsuB","tsuB",2077725,2077707,2077934,18,2077952,2077934,2077707,18
"3935","ECK2007-JW1995","yeeE",TRUE,"tsuA","tsuA",2077966,2077948,2079006,18,2079024,2079006,2077948,18
"3937","ECK2008-JW5330","yeeF",TRUE,"plaP","plaP",2079203,2079185,2080543,18,2080561,2080543,2079185,18
"3965","ECK2022-JW5836","cld",TRUE,"wzzB","wzzB",2090820,2090802,2091782,18,2091803,2091782,2090802,21
"4013","ECK2045-JW5335","nudD",TRUE,"gmm","gmm",2119242,2119224,2119703,18,2119724,2119703,2119224,21
"4045","ECK2061-JW2052","yegE",TRUE,"dgcE","dgcE",2136747,2136747,2140064,0,2140064,2140064,2136747,0
"4055","ECK2066-JW2057","yegK",TRUE,"pphC","pphC",2145210,2145192,2145953,18,2145971,2145953,2145192,18
"4059","none-JW5337","none",TRUE,"ibsB","ibsB",2147181,2147162,2147218,19,2147327,2147218,2147162,109
"4075","ECK2077-JW2066","yegQ",TRUE,"trhP","trhP",2159149,2159149,2160510,0,2160510,2160510,2159149,0
"4083","ECK2083-JW5340","gatR",TRUE,"BW25113_RS10890","BW25113_RS10890",2163192,2163174,2163650,18,2163665,2163650,2163174,15
"4085","ECK2083-JW2074","gatR",TRUE,"BW25113_RS10905","BW25113_RS10905",2164894,2164909,2165208,-15,2165232,2165208,2164909,24
"4089","ECK2085-JW2076","gatC",TRUE,"BW25113_RS10915","BW25113_RS10915",2166420,2166402,2167757,18,2167775,2167757,2166402,18
"4117","ECK2098-JW2092","yohL",TRUE,"rcnR","rcnR",2179021,2179003,2179275,18,2179293,2179275,2179003,18
"4119","ECK2099-JW2093","yohM",TRUE,"rcnA","rcnA",2179396,2179396,2180220,0,2180220,2180220,2179396,0
"4121","ECK2100-JW5346","yohN",TRUE,"rcnB","rcnB",2180259,2180439,2180777,-180,2180777,2180777,2180439,0
"4137","ECK2108-JW2102","molR",FALSE,"BW25113_RS25680","metG",2189953,2189953,2193748,0,2190777,2189812,2187779,965
"4139","ECK2108-JW5915","molR",TRUE,"BW25113_RS25680","BW25113_RS25680",2190982,2189953,2193748,1029,2192826,2193748,2189953,-922
"4141","ECK2108-JW5916","molR",FALSE,"yehI","BW25113_RS25680",2193056,2193758,2197390,-702,2193748,2193748,2189953,0
"4159","ECK2117-JW5352","yehT",TRUE,"btsR","btsR",2205740,2205722,2206441,18,2206474,2206441,2205722,33
"4161","ECK2118-JW5353","yehU",TRUE,"btsS","btsS",2206456,2206438,2208123,18,2208156,2208123,2206438,33
"4173","ECK2124-JW2119","yehZ",TRUE,"osmF","osmF",2212061,2212043,2212960,18,2212978,2212960,2212043,18
"4185","none-JW5357","none",FALSE,"yohF","yohD",2219867,2219988,2220749,-121,2219992,2219858,2219280,134
"4189","ECK2131-JW5838","yohG",TRUE,"mdtQ","mdtQ",2220820,2220802,2222237,18,2222016,2222237,2220802,-221
"4191","ECK2132-JW5358","yohH",FALSE,"yohP","mdtQ",2222046,2222461,2222544,-415,2222336,2222237,2220802,99
"4205","ECK2139-JW2133","yeiT",TRUE,"preT","preT",2227512,2227512,2228750,0,2228750,2228750,2227512,0
"4207","ECK2140-JW2134","yeiA",TRUE,"preA","preA",2228744,2228744,2229979,0,2229979,2229979,2228744,0
"4219","none-JW5360","none",FALSE,"folE","yeiB",2236477,2236463,2237131,14,2236581,2236446,2235289,135
"4237","ECK2154-JW2148","yeiJ",TRUE,"nupX","nupX",2246392,2246374,2247624,18,2247642,2247624,2246374,18
"4243","ECK2157-JW2151","yeiM",TRUE,"psuT","psuT",2249582,2249564,2250814,18,2250832,2250814,2249564,18
"4245","ECK2158-JW2152","yeiN",TRUE,"psuG","psuG",2250926,2250908,2251846,18,2251864,2251846,2250908,18
"4247","ECK2159-JW2153","yeiC",TRUE,"psuK","psuK",2251852,2251834,2252775,18,2252793,2252775,2251834,18
"4265","ECK2168-JW2162","yeiU",TRUE,"lpxT","lpxT",2262333,2262333,2263046,0,2263046,2263046,2262333,0
"4267","ECK2169-JW2163","spr",TRUE,"mepS","mepS",2263458,2263458,2264024,0,2264024,2264024,2263458,0
"4269","ECK2170-JW2164","rtn",TRUE,"pdeN","pdeN",2264205,2264205,2265761,0,2265761,2265761,2264205,0
"4285","ECK2178-JW2172","yejH",TRUE,"radD","radD",2274111,2274111,2275871,0,2275871,2275871,2274111,0
"4293","ECK2182-JW2176","yejM",TRUE,"lapC","lapC",2277855,2277855,2279615,0,2279615,2279615,2277855,0
"4339","ECK2206-JW5368","yojL",TRUE,"ftp","ftp",2303976,2303958,2305013,18,2305031,2305013,2303958,18
"4347","ECK2211-JW5917","rcsC",FALSE,"rcsC","rcsB",2310524,2310506,2313355,18,2310901,2310306,2309656,595
"4369","ECK2220-JW2221","yfaS",FALSE,"BW25113_RS11635","yfaQ",2323295,2323277,2327791,18,2323780,2323276,2321627,504
"4371","ECK2220-JW2222","yfaS",TRUE,"BW25113_RS11635","BW25113_RS11635",2323796,2323277,2327791,519,2327899,2327791,2323277,108
"4391","ECK2230-JW2232","yfaH",TRUE,"BW25113_RS11690","BW25113_RS11690",2343166,2343130,2343372,36,2343372,2343372,2343130,0
"4403","ECK2236-JW2238","yfaD",TRUE,"rpnE","rpnE",2350383,2350383,2351282,0,2351282,2351282,2350383,0
"4405","ECK2237-JW5964","ypaA",TRUE,"BW25113_RS11725","BW25113_RS11725",2351295,2351283,2351480,12,2351480,2351480,2351283,0
"4411","ECK2240-JW2241","yfaW",TRUE,"rhmD","rhmD",2353706,2353688,2354893,18,2354923,2354893,2353688,30
"4419","ECK2244-JW2245","yfaO",TRUE,"nudI","nudI",2358033,2358033,2358458,0,2358458,2358458,2358033,0
"4423","ECK2246-JW5372","yfbE",TRUE,"arnB","arnB",2359374,2359407,2360546,-33,2360546,2360546,2359407,0
"4425","ECK2247-JW2248","yfbF",TRUE,"arnC","arnC",2360550,2360550,2361518,0,2361518,2361518,2360550,0
"4427","ECK2248-JW2249","yfbG",TRUE,"arnA","arnA",2361518,2361518,2363500,0,2363500,2363500,2361518,0
"4429","ECK2249-JW2250","yfbH",TRUE,"arnD","arnD",2363497,2363497,2364387,0,2364387,2364387,2363497,0
"4433","ECK2251-JW2252","yfbW",TRUE,"arnE","arnE",2366036,2366036,2366371,0,2366371,2366371,2366036,0
"4435","ECK2252-JW5373","yfbJ",FALSE,"arnE","arnF",2366089,2366036,2366371,53,2366757,2366757,2366371,0
"4445","ECK2257-JW2258","yfbB",TRUE,"menH","menH",2370331,2370313,2371071,18,2371089,2371071,2370313,18
"4455","ECK2262-JW2263","elaC",TRUE,"rbn","rbn",2375087,2375087,2376004,0,2376004,2376004,2375087,0
"4499","ECK2284-JW2287","yfbQ",TRUE,"alaA","alaA",2401040,2401040,2402257,0,2402257,2402257,2401040,0
"4505","ECK2287-JW5376","yfbT",TRUE,"hxpA","hxpA",2404936,2404918,2405568,18,2405604,2405568,2404918,36
"4529","ECK2299-JW2302","yfcI",TRUE,"rpnB","rpnB",2416146,2416128,2417018,18,2417036,2417018,2416128,18
"4553","none-JW5379","none",FALSE,"dedA","accD",2427410,2427561,2428220,-151,2427520,2427405,2426491,115
"4569","ECK2318-JW5380","trmC",TRUE,"mnmC","mnmC",2435183,2435243,2437249,-60,2437249,2437249,2435243,0
"4573","ECK2320-JW5381","yfcM",TRUE,"epmC","epmC",2437700,2437682,2438230,18,2438434,2438230,2437682,204
"4583","ECK2325-JW2328","yfcN",TRUE,"smrB","smrB",2442085,2442085,2442636,0,2442636,2442636,2442085,0
"4595","ECK2331-JW2334","yfcT",FALSE,"yfcU","yfcS",2445853,2445835,2448480,18,2446749,2445815,2445063,934
"4603","ECK2335-JW2338","yfcX",TRUE,"fadJ","fadJ",2450512,2450494,2452638,18,2452656,2452638,2450494,18
"4605","ECK2336-JW2339","yfcY",TRUE,"fadI","fadI",2452656,2452638,2453948,18,2453966,2453948,2452638,18
"4613","ECK2340-JW2343","vacJ",TRUE,"mlaA","mlaA",2457749,2457731,2458486,18,2458504,2458486,2457731,18
"4624","ECK2346-JW5382","yfdI",FALSE,"yfdI","yfdH",2462621,2462610,2463941,11,2462755,2462613,2461693,142
"4625","ECK2347-JW5383","tfaS",TRUE,"BW25113_RS12275","BW25113_RS12275",2464282,2464294,2464584,-12,2464584,2464584,2464294,0
"4629","ECK2349-JW5384","yfdL",FALSE,"BW25113_RS12285","yfdM",2465041,2465023,2465541,18,2465733,2465866,2465591,-133
"4635","none-JW2353","none",FALSE,"yfdN","yfdM",2465910,2465866,2466360,44,2466095,2465866,2465591,229
"4637","ECK2352-JW2355","yfdO",TRUE,"BW25113_RS26000","BW25113_RS26000",2466375,2466357,2467064,18,2466743,2467064,2466357,-321
"4647","ECK2358-JW5386","ypdJ",TRUE,"yfdT","yfdT",2469352,2469352,2469657,0,2469657,2469657,2469352,0
"4679","ECK2374-JW2375","ddg",TRUE,"lpxP","lpxP",2489124,2489124,2490044,0,2490044,2490044,2489124,0
"4681","ECK2375-JW2376","yfdZ",TRUE,"alaC","alaC",2490554,2490536,2491774,18,2491792,2491774,2490536,18
"4683","ECK2376-JW5388","ypdA",TRUE,"pyrS","pyrS",2492168,2492150,2493847,18,2493847,2493847,2492150,0
"4685","ECK2377-JW2378","ypdB",TRUE,"pyrR","pyrR",2493862,2493862,2494596,0,2494596,2494596,2493862,0
"4689","ECK2379-JW2380","ypdD",TRUE,"fryA","fryA",2495487,2495469,2497964,18,2497982,2497964,2495469,18
"4695","ECK2382-JW2383","ypdG",TRUE,"fryC","fryC",2500144,2500126,2501373,18,2501391,2501373,2500126,18
"4697","ECK2383-JW5389","ypdH",TRUE,"fryB","fryB",2501413,2501395,2501721,18,2501790,2501721,2501395,69
"4709","ECK2389-JW5391","yfeA",TRUE,"pdeA","pdeA",2509140,2509122,2511311,18,2511389,2511311,2509122,78
"4719","none-JW5392","none",TRUE,"BW25113_RS12545","BW25113_RS12545",2515895,2515877,2516035,18,2516053,2516035,2515877,18
"4765","ECK2422-JW2420","yfeT",TRUE,"murR","murR",2538129,2538111,2538968,18,2538986,2538968,2538111,18
"4767","ECK2423-JW2421","yfeU",TRUE,"murQ","murQ",2539132,2539132,2540028,0,2540028,2540028,2539132,0
"4785","ECK2432-JW2430","yfeG",TRUE,"eutR","eutR",2547507,2547489,2548541,18,2548559,2548541,2547489,18
"4787","ECK2433-JW2431","yffI",TRUE,"eutK","eutK",2548605,2548587,2549087,18,2549105,2549087,2548587,18
"4805","ECK2451-JW2440","cchB",TRUE,"eutN","eutN",2565140,2565122,2565409,18,2565427,2565409,2565122,18
"4807","ECK2452-JW2441","cchA",TRUE,"eutM","eutM",2565534,2565516,2565809,18,2565827,2565809,2565516,18
"4809","ECK2453-JW2442","eutI",TRUE,"eutD","eutD",2565866,2565848,2566864,18,2566882,2566864,2565848,18
"4817","ECK2457-JW2446","ypfE",TRUE,"eutS","eutS",2568847,2568829,2569164,18,2569182,2569164,2568829,18
"4827","ECK2462-JW2451","yffH",TRUE,"nudK","nudK",2576280,2576262,2576837,18,2576855,2576837,2576262,18
"4843","ECK2470-JW2459","ypfI",TRUE,"tmcA","tmcA",2587221,2587203,2589218,18,2589236,2589218,2587203,18
"4849","ECK2473-JW2462","nlpB",TRUE,"bamC","bamC",2591208,2591190,2592224,18,2592242,2592224,2591190,18
"4883","ECK2490-JW2479","yfgC",TRUE,"bepA","bepA",2609453,2609453,2610916,0,2610916,2610916,2609453,0
"4901","ECK2499-JW2488","yfgF",TRUE,"pdeF","pdeF",2620072,2620054,2622297,18,2622315,2622297,2620054,18
"4903","none-JW5398","none",TRUE,"BW25113_RS25940","BW25113_RS25940",2622497,2622479,2622631,18,2622649,2622631,2622479,18
"4921","ECK2508-JW2496","yfgL",TRUE,"bamB","bamB",2630851,2630833,2632011,18,2632029,2632011,2630833,18
"4929","ECK2512-JW2500","yfgA",TRUE,"rodZ","rodZ",2635208,2635190,2636203,18,2636221,2636203,2635190,18
"4931","ECK2513-JW2501","yfgB",TRUE,"rlmN","rlmN",2636506,2636488,2637642,18,2637660,2637642,2636488,18
"4945","ECK2521-JW2508","yfhJ",TRUE,"iscX","iscX",2649913,2649895,2650095,18,2650113,2650095,2649895,18
"4961","ECK2529-JW2516","yfhQ",TRUE,"trmJ","trmJ",2655960,2655942,2656682,18,2656700,2656682,2655942,18
"5005","ECK2551-JW2538","yfhA",TRUE,"glrR","glrR",2680846,2680828,2682162,18,2682180,2682162,2680828,18
"5007","ECK2552-JW2539","yfhG",TRUE,"qseG","qseG",2682170,2682152,2682865,18,2682883,2682865,2682152,18
"5009","ECK2553-JW5407","yfhK",TRUE,"glrK","glrK",2683048,2683030,2684457,18,2684430,2684457,2683030,-27
"5013","ECK2556-JW2542","yfhD",TRUE,"mltF","mltF",2689298,2689160,2690716,138,2690716,2690716,2689160,0
"5017","ECK2558-JW5408","yfhB",TRUE,"pgpC","pgpC",2691292,2691274,2691909,18,2691864,2691909,2691274,-45
"5053","ECK2576-JW2562","yfiK",TRUE,"eamB","eamB",2708782,2708782,2709369,0,2709369,2709369,2708782,0
"5055","ECK2577-JW2563","yfiD",TRUE,"grcA","grcA",2709443,2709425,2709808,18,2709826,2709808,2709425,18
"5063","ECK2581-JW5409","yfiP",TRUE,"tapT","tapT",2712558,2712582,2713280,-24,2713280,2713280,2712582,0
"5065","ECK2582-JW2568","yfiQ",TRUE,"patZ","patZ",2713312,2713312,2715972,0,2715972,2715972,2713312,0
"5073","none-JW5410","none",FALSE,"rrf","kgtP",2719105,2719430,2719545,-325,2719212,2719105,2717807,107
"5075","none-JW5411","none",TRUE,"rrf","rrf",2719236,2719430,2719545,-194,2719346,2719545,2719430,-199
"5083","ECK2593-JW2577","yfiO",TRUE,"bamD","bamD",2729505,2729505,2730242,0,2730242,2730242,2729505,0
"5085","ECK2594-JW2578","yfiA",TRUE,"raiA","raiA",2730513,2730513,2730854,0,2730854,2730854,2730513,0
"5099","ECK2601-JW2585","yfiN",TRUE,"dgcN","dgcN",2735742,2735742,2736968,0,2736968,2736968,2735742,0
"5119","ECK2611-JW2596","yfjB",TRUE,"nadK","nadK",2744190,2744190,2745068,0,2745068,2745068,2744190,0
"5123","ECK2613-JW2598","smpA",TRUE,"bamE","bamE",2746964,2746964,2747305,0,2747305,2747305,2746964,0
"5127","ECK2615-JW2600","yfjG",TRUE,"ratA","ratA",2747665,2747647,2748084,18,2748141,2748084,2747647,57
"5141","ECK2623-JW2608","yfjK",TRUE,"abpB","abpB",2754728,2754710,2756899,18,2756917,2756899,2754710,18
"5143","ECK2624-JW2609","yfjL",TRUE,"abpA","abpA",2756914,2756896,2758512,18,2758530,2758512,2756896,18
"5145","none-JW5417","none",FALSE,"yfjM","abpA",2758591,2758872,2759135,-281,2758707,2758512,2756896,195
"5149","ECK2626-JW2611","yfjN",TRUE,"rnlA","rnlA",2759277,2759277,2760350,0,2760350,2760350,2759277,0
"5151","ECK2627-JW5418","yfjO",TRUE,"rnlB","rnlB",2760394,2760343,2760714,51,2760714,2760714,2760343,0
"5159","ECK2632-JW5921","yfjS",FALSE,"ypjK","yfjS",2763791,2763804,2764040,-13,2764483,2764483,2764040,0
"5165","ECK2635-JW5922","ypjL",TRUE,"BW25113_RS13765","BW25113_RS13765",2765544,2765526,2766535,18,2766137,2766535,2765526,-398
"5167","ECK2636-JW2621","yfjV",FALSE,"yfjW","BW25113_RS13765",2766213,2766677,2768380,-464,2766413,2766535,2765526,-122
"5169","ECK2637-JW5420","ypjM",FALSE,"yfjW","BW25113_RS13765",2766353,2766677,2768380,-324,2766469,2766535,2765526,-66
"5183","ECK2644-JW5422","ypjA",FALSE,"ypjA","BW25113_RS24200",2771523,2771505,2776085,18,2776232,2776269,2776150,-37
"5185","ECK2645-JW5423","pinH",TRUE,"BW25113_RS24210","BW25113_RS24210",2776442,2776424,2776642,18,2776585,2776642,2776424,-57
"5187","ECK2646-JW2629","ypjB",TRUE,"BW25113_RS25705","BW25113_RS25705",2777015,2776997,2778370,18,2777806,2778370,2776997,-564
"5189","ECK2647-JW5424","ypjC",TRUE,"BW25113_RS25705","BW25113_RS25705",2777906,2776997,2778370,909,2778304,2778370,2776997,-66
"5191","ECK2649-JW5425","ygaQ",FALSE,"BW25113_RS26005","BW25113_RS13825",2779756,2779756,2782008,0,2780088,2779196,2779121,892
"5193","ECK2650-JW2631","ygaR",TRUE,"BW25113_RS26005","BW25113_RS26005",2780107,2779756,2782008,351,2780793,2782008,2779756,-1215
"5195","ECK2651-JW5426","yqaC",FALSE,"glaH","BW25113_RS26005",2781184,2782344,2783321,-1160,2781597,2782008,2779756,-411
"5197","ECK2652-JW2633","yqaD",FALSE,"glaH","BW25113_RS26005",2781736,2782344,2783321,-608,2782008,2782008,2779756,0
"5199","ECK2653-JW5427","ygaT",TRUE,"glaH","glaH",2782239,2782344,2783321,-105,2783321,2783321,2782344,0
"5201","ECK2654-JW2635","ygaF",TRUE,"lhgD","lhgD",2783341,2783341,2784609,0,2784609,2784609,2783341,0
"5209","ECK2658-JW2639","csiR",TRUE,"glaR","glaR",2789033,2789033,2789695,0,2789695,2789695,2789033,0
"5211","ECK2659-JW2640","ygaU",TRUE,"kbp","kbp",2789714,2789696,2790145,18,2790163,2790145,2789696,18
"5221","ECK2664-JW2645","ygaW",TRUE,"alaE","alaE",2792523,2792523,2792972,0,2792972,2792972,2792523,0
"5241","ECK2674-JW2655","ygaX",FALSE,"BW25113_RS13950","proX",2801675,2801675,2802852,0,2801941,2801483,2800491,458
"5243","ECK2675-JW5428","ygaY",TRUE,"BW25113_RS13950","BW25113_RS13950",2801935,2801675,2802852,260,2802852,2802852,2801675,0
"5271","ECK2695-JW2670","ygaD",TRUE,"pncC","pncC",2817226,2817208,2817705,18,2817723,2817705,2817208,18
"5289","ECK2704-JW5843","norR",FALSE,"norR","gutQ",2824152,2824134,2825648,18,2824664,2824137,2823172,527
"5337","none-JW5436","none",TRUE,"BW25113_RS25950","BW25113_RS25950",2850260,2850242,2850376,18,2850394,2850376,2850242,18
"5361","ECK2739-JW2714","surE",TRUE,"umpG","umpG",2862890,2862872,2863633,18,2863651,2863633,2862872,18
"5381","ECK2749-JW5438","ygbF",TRUE,"cas2","cas2",2871946,2871928,2872212,18,2872296,2872212,2871928,84
"5383","ECK2750-JW2725","ygbT",TRUE,"cas1","cas1",2872232,2872214,2873131,18,2873149,2873131,2872214,18
"5385","ECK2751-JW2726","ygcH",TRUE,"casE","casE",2873165,2873147,2873746,18,2873764,2873746,2873147,18
"5387","ECK2752-JW5844","ygcI",TRUE,"casD","casD",2873751,2873733,2874407,18,2874425,2874407,2873733,18
"5389","ECK2753-JW2728","ygcJ",TRUE,"casC","casC",2874428,2874410,2875501,18,2875519,2875501,2874410,18
"5391","ECK2754-JW2729","ygcK",TRUE,"casB","casB",2875532,2875514,2875996,18,2876014,2875996,2875514,18
"5393","ECK2755-JW2730","ygcL",TRUE,"casA","casA",2876007,2875989,2877497,18,2877515,2877497,2875989,18
"5395","ECK2756-JW2731","ygcB",TRUE,"cas3","cas3",2877930,2877912,2880578,18,2880596,2880578,2877912,18
"5403","ECK2760-JW2735","ygcM",TRUE,"queD","queD",2885573,2885576,2885938,-3,2885938,2885938,2885576,0
"5425","ECK2771-JW2748","ygcF",TRUE,"queE","queE",2898124,2898106,2898777,18,2898795,2898777,2898106,18
"5435","ECK2776-JW2753","chpA",TRUE,"mazF","mazF",2904133,2904115,2904450,18,2904468,2904450,2904115,18
"5437","ECK2777-JW2754","chpR",TRUE,"mazE","mazE",2904468,2904450,2904698,18,2904716,2904698,2904450,18
"5441","ECK2779-JW2756","rumA",TRUE,"rlmD","rlmD",2907076,2907058,2908359,18,2908377,2908359,2907058,18
"5453","ECK2785-JW2762","yqcB",TRUE,"truC","truC",2916379,2916361,2917143,18,2917161,2917143,2916361,18
"5459","ECK2789-JW2765","yqcD",TRUE,"queF","queF",2918707,2918707,2919555,0,2919555,2919555,2918707,0
"5461","ECK2790-JW2766","ygdH",TRUE,"ppnN","ppnN",2919667,2919667,2921031,0,2921031,2921031,2919667,0
"5467","ECK2793-JW5446","exo",TRUE,"ygdG","ygdG",2924324,2924414,2925169,-90,2925169,2925169,2924414,0
"5483","ECK2801-JW2777","ygdE",TRUE,"rlmM","rlmM",2933520,2933502,2934602,18,2934620,2934602,2933502,18
"5485","none-JW5447","none",FALSE,"rlmM","fucR",2933698,2933502,2934602,196,2933895,2933458,2932727,437
"5495","ECK2807-JW2782","ygdK",TRUE,"csdE","csdE",2937901,2937901,2938344,0,2938344,2938344,2937901,0
"5497","ECK2808-JW2783","ygdL",TRUE,"tcdA","tcdA",2938413,2938395,2939201,18,2939219,2939201,2938395,18
"5509","ECK2817-JW2789","ptr",TRUE,"ptrA","ptrA",2949373,2949355,2952243,18,2952261,2952243,2949355,18
"5517","ECK2821-JW5451","ppdB",FALSE,"ppdB","ppdA",2956530,2956512,2957075,18,2957333,2957536,2957066,-203
"5527","ECK2826-JW2798","nudH",TRUE,"rppH","rppH",2961824,2961806,2962336,18,2962354,2962336,2961806,18
"5529","none-JW5452","none",FALSE,"mutH","rppH",2962648,2963021,2963710,-373,2962842,2962336,2961806,506
"5539","ECK2831-JW2803","ygeD",TRUE,"lplT","lplT",2966046,2966028,2967221,18,2967239,2967221,2966028,18
"5569","ECK2848-JW2818","ygeF",TRUE,"BW25113_RS14825","BW25113_RS14825",2983913,2983913,2984359,0,2984359,2984359,2983913,0
"5577","ECK2852-JW5457","pbl",TRUE,"BW25113_RS14845","BW25113_RS14845",2987358,2987298,2987774,60,2987774,2987774,2987298,0
"5579","ECK2853-JW5458","ygeK",TRUE,"BW25113_RS14850","BW25113_RS14850",2987837,2987819,2988451,18,2988283,2988451,2987819,-168
"5581","ECK2854-JW2824","ygeL",FALSE,"BW25113_RS26010","BW25113_RS14850",2988314,2988673,2989104,-359,2988469,2988451,2987819,18
"5583","ECK2855-JW5459","ygeM",TRUE,"BW25113_RS26010","BW25113_RS26010",2988691,2988673,2989104,18,2989122,2989104,2988673,18
"5585","ECK2856-JW5460","ygeN",TRUE,"BW25113_RS25255","BW25113_RS25255",2989125,2989107,2989328,18,2989379,2989328,2989107,51
"5587","ECK2857-JW5846","ygeO",TRUE,"BW25113_RS24250","BW25113_RS24250",2989339,2989321,2989719,18,2989764,2989719,2989321,45
"5589","ECK2858-JW2831","ygeP",FALSE,"BW25113_RS14890","BW25113_RS14875",2991066,2991051,2992187,15,2991365,2990959,2989731,406
"5591","ECK2859-JW5461","ygeQ",TRUE,"BW25113_RS14890","BW25113_RS14890",2991411,2991051,2992187,360,2992247,2992187,2991051,60
"5593","ECK2861-JW2833","ygeR",TRUE,"actS","actS",2992513,2992495,2993250,18,2993268,2993250,2992495,18
"5617","ECK2873-JW2845","ygfJ",TRUE,"mocA","mocA",3008519,3008519,3009097,0,3009097,3009097,3008519,0
"5627","ECK2878-JW2850","ygfO",TRUE,"xanQ","xanQ",3017710,3017710,3019110,0,3019110,3019110,3017710,0
"5631","ECK2880-JW5467","ygfQ",TRUE,"ghxQ","ghxQ",3020480,3020480,3021847,0,3021847,3021847,3020480,0
"5637","ECK2883-JW5470","ygfU",TRUE,"uacT","uacT",3024726,3024726,3026174,0,3026174,3026174,3024726,0
"5639","none-JW5471","none",TRUE,"yqfG","yqfG",3026176,3026176,3026301,0,3026301,3026301,3026176,0
"5657","ECK2892-JW2865","ygfY",TRUE,"sdhE","sdhE",3034181,3034163,3034429,18,3034447,3034429,3034163,18
"5661","ECK2894-JW2867","yqfA",TRUE,"trhA","trhA",3035866,3035848,3036507,18,3036525,3036507,3035848,18
"5675","ECK2901-JW2874","visC",TRUE,"ubiI","ubiI",3044492,3044474,3045676,18,3045694,3045676,3044474,18
"5685","none-JW5474","none",TRUE,"ssrS","ssrS",3049268,3049342,3049525,-74,3049594,3049525,3049342,69
"5687","ECK2907-JW2879","ygfA",TRUE,"fau","fau",3049600,3049546,3050148,54,3050148,3050148,3049546,0
"5693","ECK2911-JW2882","yqfE",TRUE,"BW25113_RS15150","BW25113_RS15150",3052758,3052740,3052970,18,3052988,3052970,3052740,18
"5697","ECK2913-JW2884","yliK",TRUE,"scpA","scpA",3054209,3054209,3056353,0,3056353,3056353,3054209,0
"5701","ECK2915-JW2886","ygfG",TRUE,"scpB","scpB",3057352,3057352,3058137,0,3058137,3058137,3057352,0
"5703","ECK2916-JW2887","ygfH",TRUE,"scpC","scpC",3058161,3058161,3059639,0,3059639,3059639,3058161,0
"5705","ECK2917-JW5476","ygfI",TRUE,"srsR","srsR",3059654,3059636,3060532,18,3060565,3060532,3059636,33
"5721","ECK2925-JW2896","yggD",TRUE,"fumE","fumE",3068063,3068045,3068554,18,3068572,3068554,3068045,18
"5733","ECK2931-JW2903","yggG",TRUE,"loiP","loiP",3075272,3075272,3076030,0,3076030,3076030,3075272,0
"5743","ECK2936-JW2908","yqgD",TRUE,"yqgC","yqgC",3079776,3079546,3079761,230,3080027,3079761,3079546,266
"5749","ECK2939-JW2911","sprT",TRUE,"yggI","yggI",3083114,3083114,3083611,0,3083611,3083611,3083114,0
"5753","ECK2941-JW2913","yggJ",TRUE,"rsmE","rsmE",3084493,3084493,3085224,0,3085224,3085224,3084493,0
"5769","ECK2949-JW2921","yggV",TRUE,"rdgB","rdgB",3090040,3090040,3090633,0,3090633,3090633,3090040,0
"5771","ECK2950-JW2922","yggW",TRUE,"hemW","hemW",3090626,3090626,3091762,0,3091762,3091762,3090626,0
"5779","none-JW5480","none",FALSE,"yggL","yggN",3095021,3095166,3095492,-145,3095161,3094982,3094263,179
"5783","ECK2955-JW2927","yggH",TRUE,"trmB","trmB",3095510,3095492,3096211,18,3096229,3096211,3095492,18
"5799","ECK2964-JW5924","yghE",TRUE,"gspL","gspL",3104505,3104487,3105452,18,3105281,3105452,3104487,-171
"5809","ECK2969-JW2942","yghK",TRUE,"glcA","glcA",3112974,3112956,3114638,18,3114656,3114638,3112956,18
"5857","ECK2993-JW5926","yghX",TRUE,"BW25113_RS15580","BW25113_RS15580",3140233,3140215,3141099,18,3140613,3141099,3140215,-486
"5859","ECK2994-JW5496","yghY",TRUE,"BW25113_RS15580","BW25113_RS15580",3140643,3140215,3141099,428,3140996,3141099,3140215,-103
"5861","none-JW5497","none",FALSE,"gpr","BW25113_RS15580",3140974,3141256,3142296,-282,3141117,3141099,3140215,18
"5863","ECK2995-JW2970","yghZ",TRUE,"gpr","gpr",3141256,3141256,3142296,0,3142296,3142296,3141256,0
"5889","ECK3008-JW2985","sufI",TRUE,"ftsP","ftsP",3154634,3154616,3156028,18,3156046,3156028,3154616,18
"5897","ECK3012-JW2989","ygiT",TRUE,"mqsA","mqsA",3161228,3161210,3161605,18,3161623,3161605,3161210,18
"5899","ECK3013-JW2990","ygiU",TRUE,"mqsR","mqsR",3161625,3161607,3161903,18,3161921,3161903,3161607,18
"5931","ECK3030-JW3007","zupT",TRUE,"ygiD","ygiD",3174996,3174978,3175766,18,3175811,3175766,3174978,45
"5933","ECK3031-JW3008","ygiE",TRUE,"zupT","zupT",3175909,3175909,3176682,0,3176682,3176682,3175909,0
"5937","ECK3033-JW5505","yqiC",TRUE,"ubiK","ubiK",3178199,3178199,3178489,0,3178489,3178489,3178199,0
"5941","ECK3035-JW5507","yqiG",FALSE,"ybgQ","BW25113_RS15805",3180759,3180759,3183224,0,3181702,3180774,3179546,928
"5953","ECK3042-JW3024","rfaE",TRUE,"hldE","hldE",3188697,3188679,3190112,18,3190130,3190112,3188679,18
"5959","ECK3045-JW3027","htrG",TRUE,"ygiM","ygiM",3194566,3194566,3195186,0,3195186,3195186,3194566,0
"5967","ECK3049-JW3031","ygiH",TRUE,"plsY","plsY",3198053,3198053,3198670,0,3198670,3198670,3198053,0
"5969","ECK3050-JW3032","ygiP",TRUE,"ttdR","ttdR",3198701,3198683,3199615,18,3199633,3199615,3198683,18
"5975","ECK3053-JW3035","ygjE",TRUE,"ttdT","ttdT",3201383,3201383,3202846,0,3202846,3202846,3201383,0
"5977","ECK3054-JW3036","ygjD",TRUE,"tsaD","tsaD",3202907,3202889,3203902,18,3203920,3203902,3202889,18
"5985","ECK3058-JW3040","ygjF",TRUE,"mug","mug",3208344,3208326,3208832,18,3208850,3208832,3208326,18
"5987","ECK3060-JW3041","yqjH",TRUE,"nfeF","nfeF",3209104,3209086,3209850,18,3209868,3209850,3209086,18
"5989","ECK3061-JW3042","yqjI",TRUE,"nfeR","nfeR",3210138,3210138,3210761,0,3210761,3210761,3210138,0
"5993","ECK3063-JW5510","ygjG",TRUE,"patA","patA",3212826,3212853,3214232,-27,3214232,3214232,3212853,0
"6011","ECK3072-JW3053","ygjM",TRUE,"higA","higA",3227105,3227087,3227503,18,3227521,3227503,3227087,18
"6013","ECK3073-JW3054","ygjN",TRUE,"higB","higB",3227518,3227500,3227814,18,3227832,3227814,3227500,18
"6015","ECK3074-JW5513","ygjO",TRUE,"rlmG","rlmG",3228116,3228098,3229234,18,3229252,3229234,3228098,18
"6039","ECK3087-JW3067","yqjB",TRUE,"mzrA","mzrA",3241798,3241798,3242181,0,3242181,3242181,3241798,0
"6063","ECK3099-JW5518","yhaM",TRUE,"cyuA","cyuA",3248718,3248700,3250010,18,3250028,3250010,3248700,18
"6065","ECK3100-JW5519","yhaO",TRUE,"cyuP","cyuP",3250056,3250038,3251369,18,3251324,3251369,3250038,-45
"6097","ECK3117-JW3098","sohA",TRUE,"prlF","prlF",3270361,3270361,3270696,0,3270696,3270696,3270361,0
"6107","ECK3122-JW3103","agaW",TRUE,"BW25113_RS16250","BW25113_RS16250",3274060,3274060,3274431,0,3274461,3274431,3274060,30
"6109","ECK3123-JW5527","agaA",TRUE,"BW25113_RS16255","BW25113_RS16255",3274481,3274427,3274984,54,3274984,3274984,3274427,0
"6131","ECK3134-JW3115","yraL",TRUE,"rsmI","rsmI",3285852,3285834,3286694,18,3286712,3286694,3285834,18
"6133","ECK3135-JW3116","yraM",TRUE,"lpoA","lpoA",3286759,3286759,3288795,0,3288795,3288795,3286759,0
"6137","ECK3137-JW3118","yraO",TRUE,"diaA","diaA",3289168,3289168,3289758,0,3289758,3289758,3289168,0
"6139","ECK3138-JW3119","yraP",TRUE,"dolP","dolP",3289768,3289768,3290343,0,3290343,3290343,3289768,0
"6153","ECK3145-JW3126","yhbT",TRUE,"ubiT","ubiT",3294129,3294111,3294635,18,3294653,3294635,3294111,18
"6155","ECK3146-JW3127","yhbU",TRUE,"ubiU","ubiU",3294844,3294844,3295839,0,3295839,3295839,3294844,0
"6157","ECK3147-JW5530","yhbV",TRUE,"ubiV","ubiV",3295848,3295848,3296726,0,3296726,3296726,3295848,0
"6163","ECK3150-JW5531","deaD",FALSE,"deaD","yrbN",3299348,3299330,3301219,18,3301288,3301292,3301212,-4
"6179","ECK3159-JW5533","yhbC",TRUE,"rimP","rimP",3310931,3310913,3311365,18,3311383,3311365,3310913,18
"6193","ECK3168-JW3146","rrmJ",TRUE,"rlmE","rlmE",3320412,3320394,3321023,18,3321041,3321023,3320394,18
"6215","ECK3179-JW3157","yrbA",TRUE,"ibaG","ibaG",3329926,3329908,3330162,18,3330180,3330162,3329908,18
"6217","ECK3180-JW5535","yrbB",TRUE,"mlaB","mlaB",3330340,3330322,3330615,18,3330633,3330615,3330322,18
"6219","ECK3181-JW3159","yrbC",TRUE,"mlaC","mlaC",3330633,3330615,3331250,18,3331268,3331250,3330615,18
"6221","ECK3182-JW3160","yrbD",TRUE,"mlaD","mlaD",3331287,3331269,3331820,18,3331838,3331820,3331269,18
"6223","ECK3183-JW3161","yrbE",TRUE,"mlaE","mlaE",3331843,3331825,3332607,18,3332625,3332607,3331825,18
"6225","ECK3184-JW3162","yrbF",TRUE,"mlaF","mlaF",3332633,3332615,3333424,18,3333442,3333424,3332615,18
"6233","ECK3188-JW3166","yrbK",TRUE,"lptC","lptC",3336195,3336195,3336770,0,3336770,3336770,3336195,0
"6235","ECK3189-JW3167","yhbN",TRUE,"lptA","lptA",3336769,3336739,3337296,30,3337296,3337296,3336739,0
"6237","ECK3190-JW3168","yhbG",TRUE,"lptB","lptB",3337303,3337303,3338028,0,3338028,3338028,3337303,0
"6241","ECK3192-JW3170","yhbH",TRUE,"hpf","hpf",3339532,3339532,3339819,0,3339819,3339819,3339532,0
"6245","ECK3194-JW3172","yhbJ",TRUE,"rapZ","rapZ",3340474,3340474,3341328,0,3341328,3341328,3340474,0
"6269","ECK3207-JW3184","yhcE",TRUE,"BW25113_RS16670","BW25113_RS16670",3358544,3358544,3358912,0,3359023,3358912,3358544,111
"6271","ECK3207-JW3187","yhcE",TRUE,"BW25113_RS16685","BW25113_RS16685",3360040,3360109,3360288,-69,3360288,3360288,3360109,0
"6277","ECK3210-JW3190","yhcH",TRUE,"nanQ","nanQ",3362391,3362373,3362837,18,3362855,3362837,3362373,18
"6299","ECK3221-JW3201","yhcM",TRUE,"zapE","zapE",3372247,3372229,3373356,18,3373374,3373356,3372229,18
"6301","ECK3222-JW5539","yhcB",TRUE,"zapG","zapG",3373550,3373550,3373948,0,3373948,3373948,3373550,0
"6337","ECK3240-JW3221","yhdA",TRUE,"csrD","csrD",3394769,3394751,3396691,18,3396709,3396691,3394751,18
"6367","ECK3255-JW3236","yhdW",TRUE,"BW25113_RS16950","BW25113_RS16950",3412508,3412401,3413425,107,3413425,3413425,3412401,0
"6412","ECK3980-JW3952","htrC",TRUE,"yjaZ","yjaZ",4179714,4179714,4180253,0,4180253,4180253,4179714,0
"6430","ECK3971-JW3943","tufB",TRUE,"tuf","tuf",4165872,4165872,4167056,0,4167056,4167056,4165872,0
"6452","none-JW5552","none",FALSE,"oxyR","argH",4148162,4148418,4149335,-256,4148266,4148151,4146778,115
"6462","none-JW5554","none",FALSE,"argE","ppc",4143262,4143624,4144775,-362,4143564,4143026,4140375,538
"6466","ECK3946-JW3927","yijP",TRUE,"eptC","eptC",4138478,4138460,4140193,18,4140211,4140193,4138460,18
"6518","ECK3920-JW3899","yiiU",TRUE,"zapB","zapB",4108443,4108443,4108688,0,4108688,4108688,4108443,0
"6528","ECK3915-JW3894","yiiT",TRUE,"uspD","uspD",4103221,4103221,4103649,0,4103649,4103649,4103221,0
"6564","ECK3894-JW3872","yiiL",TRUE,"rhaM","rhaM",4086502,4086484,4086798,18,4086816,4086798,4086484,18
"6586","ECK3883-JW5563","yiiF",TRUE,"BW25113_RS20185","BW25113_RS20185",4073111,4073087,4073329,24,4073329,4073329,4073087,0
"6590","none-JW5565","none",FALSE,"yiiE","fabY",4072209,4072651,4072869,-442,4072316,4071798,4070857,518
"6592","ECK3881-JW3859","yiiD",TRUE,"fabY","fabY",4070809,4070857,4071798,-48,4071798,4071798,4070857,0
"6596","ECK3879-JW3857","rbn",TRUE,"yihY","yihY",4069506,4069506,4070378,0,4070378,4070378,4069506,0
"6600","ECK3877-JW5567","yihW",TRUE,"csqR","csqR",4068029,4068029,4068814,0,4068814,4068814,4068029,0
"6634","none-JW5572","none",TRUE,"yshB","yshB",4047025,4047007,4047117,18,4047135,4047117,4047007,18
"6650","ECK3851-JW3831","yihE",TRUE,"srkA","srkA",4035776,4035775,4036761,1,4036761,4036761,4035775,0
"6686","ECK3828-JW3811","yigP",TRUE,"ubiJ","ubiJ",4012984,4012984,4013589,0,4013589,4013589,4012984,0
"6700","ECK3821-JW3803","yigM",TRUE,"bioP","bioP",4004436,4004436,4005335,0,4005335,4005335,4004436,0
"6718","ECK3812-JW5590","yigG",TRUE,"BW25113_RS19825","BW25113_RS19825",3996191,3996173,3996589,18,3996571,3996589,3996173,-18
"6738","ECK3802-JW3780","yzcX",TRUE,"cyaY","cyaY",3987210,3987099,3987419,111,3987695,3987419,3987099,276
"6762","ECK3785-JW5596","rffT",TRUE,"wecF","wecF",3970885,3970885,3971964,0,3971964,3971964,3970885,0
"6766","ECK3783-JW3765","rffA",TRUE,"wecE","wecE",3968506,3968506,3969636,0,3969636,3969636,3968506,0
"6774","ECK3779-JW5599","rffD",TRUE,"wecC","wecC",3964620,3964620,3965882,0,3965882,3965882,3964620,0
"6776","ECK3778-JW5600","rffE",TRUE,"wecB","wecB",3963493,3963493,3964623,0,3964623,3964623,3963493,0
"6794","ECK3769-JW3750","yifN",TRUE,"BW25113_RS25790","BW25113_RS25790",3953620,3953372,3953820,248,3953838,3953820,3953372,18
"6796","ECK3768-JW3749","yifO",TRUE,"BW25113_RS25790","BW25113_RS25790",3953390,3953372,3953820,18,3953665,3953820,3953372,-155
"6812","ECK3760-JW3741","ilvG",FALSE,"ilvM","BW25113_RS19570",3944983,3945561,3945824,-578,3945564,3945564,3943920,0
"6814","ECK3760-JW3740","ilvG",TRUE,"BW25113_RS19570","BW25113_RS19570",3943920,3943920,3945564,0,3944903,3945564,3943920,-661
"6820","ECK3757-JW3737","yifE",TRUE,"maoP","maoP",3941446,3941446,3941784,0,3941784,3941784,3941446,0
"6826","ECK3748-JW3733","hsrA",TRUE,"mdtD","mdtD",3932563,3932545,3933972,18,3933990,3933972,3932545,18
"6840","ECK3741-JW5609","trkD",TRUE,"kup","kup",3924676,3924676,3926544,0,3926544,3926544,3924676,0
"6842","ECK3740-JW3725","yieN",TRUE,"ravA","ravA",3922975,3922957,3924453,18,3924471,3924453,3922957,18
"6844","ECK3739-JW5610","yieM",TRUE,"viaA","viaA",3921530,3921512,3922963,18,3922981,3922963,3921512,18
"6852","ECK3734-JW3719","gidA",TRUE,"mnmG","mnmG",3917122,3917104,3918993,18,3919011,3918993,3917104,18
"6854","ECK3733-JW3718","gidB",TRUE,"rsmG","rsmG",3916435,3916417,3917040,18,3917058,3917040,3916417,18
"6902","ECK3709-JW3694","yieI",TRUE,"cbrB","cbrB",3890866,3890866,3891333,0,3891333,3891333,3890866,0
"6906","ECK3707-JW3692","yieG",TRUE,"adeP","adeP",3888650,3888632,3889969,18,3889987,3889969,3888632,18
"6924","ECK3699-JW3684","trmE",TRUE,"mnmE","mnmE",3880188,3880188,3881552,0,3881552,3881552,3880188,0
"6972","ECK3675-JW3660","glvC",TRUE,"BW25113_RS19145","BW25113_RS19145",3855875,3855347,3856963,528,3856981,3856963,3855347,18
"6974","ECK3674-JW3659","glvB",FALSE,"BW25113_RS19145","BW25113_RS19135",3855365,3855347,3856963,18,3855850,3855347,3854533,503
"6976","ECK3673-JW3658","glvG",TRUE,"BW25113_RS19135","BW25113_RS19135",3854727,3854533,3855347,194,3855365,3855347,3854533,18
"6978","ECK3672-JW5937","ysdC",FALSE,"BW25113_RS19135","yidL",3854551,3854533,3855347,18,3854763,3854536,3853643,227
"6996","none-JW5635","none",TRUE,"ivbL","ivbL",3846233,3846250,3846348,-17,3846625,3846348,3846250,277
"7012","ECK3656-JW3640","ade",TRUE,"adeD","adeD",3837324,3837324,3839090,0,3839090,3839090,3837324,0
"7014","ECK3655-JW5636","yicO",TRUE,"adeQ","adeQ",3835833,3835815,3837149,18,3837167,3837149,3835815,18
"7018","ECK3653-JW5938","yicM",TRUE,"nepI","nepI",3833927,3833909,3835099,18,3835117,3835099,3833909,18
"7022","none-JW5639","none",FALSE,"yicS","nlpA",3833451,3833575,3833868,-124,3833570,3833353,3832535,217
"7036","ECK3644-JW3629","yicE",TRUE,"xanP","xanP",3822305,3822305,3823696,0,3823696,3823696,3822305,0
"7062","ECK3631-JW5641","ttk",TRUE,"slmA","slmA",3807854,3807854,3808450,0,3808450,3808450,3807854,0
"7078","ECK3623-JW3608","kdtA",TRUE,"waaA","waaA",3801900,3801900,3803177,0,3803177,3803177,3801900,0
"7080","ECK3622-JW3607","rfaQ",TRUE,"waaQ","waaQ",3800442,3800424,3801494,18,3801476,3801494,3800424,-18
"7082","ECK3621-JW3606","rfaG",TRUE,"waaG","waaG",3799321,3799303,3800427,18,3800445,3800427,3799303,18
"7084","ECK3620-JW3605","rfaP",TRUE,"waaP","waaP",3798531,3798513,3799310,18,3799328,3799310,3798513,18
"7086","ECK3619-JW3604","rfaS",TRUE,"waaS","waaS",3797559,3797541,3798476,18,3798494,3798476,3797541,18
"7088","ECK3618-JW3603","rfaB",TRUE,"waaB","waaB",3796436,3796418,3797497,18,3797545,3797497,3796418,48
"7090","ECK3617-JW3602","rfaI",TRUE,"waaO","waaO",3795417,3795399,3796418,18,3796436,3796418,3795399,18
"7092","ECK3616-JW3601","rfaJ",TRUE,"waaJ","waaJ",3794361,3794343,3795359,18,3795377,3795359,3794343,18
"7094","ECK3615-JW3600","rfaY",TRUE,"waaY","waaY",3793645,3793627,3794325,18,3794343,3794325,3793627,18
"7096","ECK3614-JW3599","rfaZ",TRUE,"waaZ","waaZ",3792723,3792705,3793556,18,3793574,3793556,3792705,18
"7098","ECK3613-JW3598","rfaK",TRUE,"waaU","waaU",3791617,3791599,3792672,18,3792690,3792672,3791599,18
"7100","ECK3612-JW3597","rfaL",TRUE,"waaL","waaL",3790308,3790308,3791567,0,3791567,3791567,3790308,0
"7102","ECK3611-JW3596","rfaC",TRUE,"waaC","waaC",3789339,3789339,3790298,0,3790298,3790298,3789339,0
"7104","ECK3610-JW3595","rfaF",TRUE,"waaF","waaF",3788289,3788289,3789335,0,3789335,3789335,3788289,0
"7114","ECK3605-JW3590","yibD",TRUE,"waaH","waaH",3782425,3782407,3783441,18,3783459,3783441,3782407,18
"7120","ECK3602-JW3587","gpmI",TRUE,"gpmM","gpmM",3778620,3778620,3780164,0,3780164,3780164,3778620,0
"7132","ECK3596-JW3581","yibK",TRUE,"trmL","trmL",3774575,3774575,3775048,0,3775048,3775048,3774575,0
"7156","ECK3584-JW5647","yibJ",TRUE,"BW25113_RS18665","BW25113_RS18665",3760581,3760567,3761525,14,3761282,3761525,3760567,-243
"7180","none-JW5649","none",TRUE,"BW25113_RS25765","BW25113_RS25765",3744233,3744278,3744466,-45,3744706,3744466,3744278,240
"7200","ECK3563-JW3546","yiaJ",TRUE,"plaR","plaR",3735062,3735044,3735892,18,3735910,3735892,3735044,18
"7202","ECK3562-JW3545","yiaI",TRUE,"ysaA","ysaA",3734487,3734469,3734942,18,3734960,3734942,3734469,18
"7226","ECK3550-JW3533","yiaH",TRUE,"wecH","wecH",3719247,3719247,3720242,0,3720242,3720242,3719247,0
"7242","ECK3540-JW5656","tiaE",TRUE,"ghrB","ghrB",3710670,3710670,3711644,0,3711644,3711644,3710670,0
"7258","none-JW5661","none",TRUE,"BW25113_RS23145","BW25113_RS23145",3701598,3701808,3701941,-210,3701939,3701941,3701808,-2
"7262","none-JW5662","none",FALSE,"dppA","dppB",3699237,3699458,3701065,-221,3699395,3699150,3698131,245
"7282","ECK3519-JW5941","yhjQ",TRUE,"bcsQ","bcsQ",3688611,3688593,3689345,18,3689327,3689345,3688593,-18
"7292","ECK3514-JW5943","yhjK",TRUE,"pdeK","pdeK",3677008,3676990,3678978,18,3678957,3678978,3676990,-21
"7300","ECK3510-JW3493","yhjH",TRUE,"pdeH","pdeH",3671798,3671780,3672547,18,3672565,3672547,3671780,18
"7308","ECK3506-JW3489","yhjC",TRUE,"rcdB","rcdB",3665702,3665774,3666673,-72,3666673,3666673,3665774,0
"7314","ECK3503-JW3486","yhjA",TRUE,"ccp","ccp",3661169,3661151,3662548,18,3662566,3662548,3661151,18
"7336","ECK3491-JW3475","yhiF",TRUE,"dctR","dctR",3648043,3648043,3648573,0,3648573,3648573,3648043,0
"7340","ECK3489-JW3471","yhiS",TRUE,"BW25113_RS18155","BW25113_RS18155",3644651,3644651,3645397,0,3645433,3645397,3644651,36
"7350","ECK3484-JW3466","yhiR",TRUE,"rlmJ","rlmJ",3638745,3638745,3639587,0,3639587,3639587,3638745,0
"7354","ECK3482-JW5672","yhiQ",TRUE,"rsmJ","rsmJ",3635758,3635740,3636492,18,3636510,3636492,3635740,18
"7356","ECK3481-JW3463","yhiP",TRUE,"dtpB","dtpB",3634222,3634222,3635691,0,3635691,3635691,3634222,0
"7360","ECK3479-JW3461","yhiO",TRUE,"uspB","uspB",3632763,3632745,3633080,18,3633098,3633080,3632745,18
"7368","ECK3475-JW3457","yhiL",TRUE,"BW25113_RS18065","BW25113_RS18065",3626598,3626212,3627818,386,3627836,3627818,3626212,18
"7370","ECK3474-JW5674","yhiK",FALSE,"BW25113_RS18065","yhiJ",3626230,3626212,3627818,18,3626622,3625950,3624328,672
"7374","none-JW5675","none",FALSE,"yhiJ","yhiI",3623973,3624328,3625950,-355,3624104,3623962,3622895,142
"7384","ECK3468-JW5678","yrhC",TRUE,"BW25113_RS18035","BW25113_RS18035",3617247,3617247,3617597,0,3617492,3617597,3617247,-105
"7412","ECK3454-JW3435","yhhP",TRUE,"tusA","tusA",3602129,3602111,3602356,18,3602374,3602356,3602111,18
"7422","ECK3449-JW3430","yhhF",TRUE,"rsmD","rsmD",3597753,3597753,3598349,0,3598349,3598349,3597753,0
"7434","ECK3443-JW3424","yhhK",TRUE,"panZ","panZ",3591344,3591344,3591727,0,3591727,3591727,3591344,0
"7462","none-JW5684","none",TRUE,"yrhD","yrhD",3577764,3577764,3577919,0,3577919,3577919,3577764,0
"7464","ECK3429-JW5864","yrhA",TRUE,"BW25113_RS17825","BW25113_RS17825",3576398,3576398,3576814,0,3576814,3576814,3576398,0
"7494","ECK3413-JW3390","yzgL",TRUE,"BW25113_RS17750","BW25113_RS17750",3557102,3557147,3557368,-45,3557383,3557368,3557147,15
"7502","ECK3409-JW3386","glpR",TRUE,"BW25113_RS17730","BW25113_RS17730",3553225,3553207,3553965,18,3553983,3553965,3553207,18
"7518","ECK3401-JW3377","gntY",TRUE,"nfuA","nfuA",3538983,3538983,3539558,0,3539558,3539558,3538983,0
"7520","ECK3400-JW5691","gntX",TRUE,"yhgH","yhgH",3538241,3538241,3538924,0,3538924,3538924,3538241,0
"7524","ECK3398-JW3374","yhgA",TRUE,"rpnA","rpnA",3536526,3536526,3537404,0,3537404,3537404,3536526,0
"7526","ECK3397-JW3373","yhgG",TRUE,"feoC","feoC",3536087,3536087,3536323,0,3536323,3536323,3536087,0
"7550","ECK3385-JW3361","yrfF",TRUE,"igaA","igaA",3519828,3519828,3521963,0,3521963,3521963,3519828,0
"7556","ECK3382-JW5693","yrfD",TRUE,"hofM","hofM",3515349,3515331,3516110,18,3516128,3516110,3515331,18
"7558","ECK3381-JW3357","yrfC",TRUE,"hofN","hofN",3514810,3514792,3515331,18,3515349,3515331,3514792,18
"7560","ECK3380-JW3356","yrfB",TRUE,"hofO","hofO",3514386,3514368,3514808,18,3514826,3514808,3514368,18
"7562","ECK3379-JW5694","yrfA",TRUE,"hofP","hofP",3513992,3513974,3514378,18,3514396,3514378,3513974,18
"7656","ECK3332-JW3307","yheN",TRUE,"tusD","tusD",3468709,3468691,3469077,18,3469095,3469077,3468691,18
"7658","ECK3331-JW3306","yheM",TRUE,"tusC","tusC",3468350,3468332,3468691,18,3468709,3468691,3468332,18
"7660","ECK3330-JW3305","yheL",TRUE,"tusB","tusB",3468055,3468037,3468324,18,3468342,3468324,3468037,18
"7702","ECK3309-JW3284","pioO",TRUE,"gspB","gspB",3446885,3446867,3447286,18,3447304,3447286,3446867,18
"7764","ECK3278-JW3253","yhdL",TRUE,"arfA","arfA",3431808,3431790,3432008,18,3432026,3432008,3431790,18
"7782","ECK3269-JW3243","yrdC",TRUE,"tsaC","tsaC",3424220,3424202,3424774,18,3424792,3424774,3424202,18
"7811","ECK4014-JW3982","yjbC",TRUE,"rluF","rluF",4220282,4220282,4221154,0,4221154,4221154,4220282,0
"7827","ECK4022-JW3990","yjbA",TRUE,"psiE","psiE",4230253,4230253,4230663,0,4230663,4230663,4230253,0
"7843","none-JW5712","none",FALSE,"BW25113_RS20970","malM",4240631,4240631,4242211,0,4240825,4240402,4239482,423
"7845","ECK4030-JW3998","yjbI",TRUE,"BW25113_RS20970","BW25113_RS20970",4240883,4240631,4242211,252,4242211,4242211,4240631,0
"7863","ECK4039-JW4007","yjbL",FALSE,"BW25113_RS21020","zur",4250249,4250249,4251234,0,4250503,4249931,4249416,572
"7865","ECK4040-JW4008","yjbM",TRUE,"BW25113_RS21020","BW25113_RS21020",4250527,4250249,4251234,278,4251234,4251234,4250249,0
"7867","ECK4041-JW5950","yjbN",TRUE,"dusA","dusA",4251642,4251597,4252634,45,4252634,4252634,4251597,0
"7869","ECK4042-JW5716","yjbO",TRUE,"pspG","pspG",4252768,4252768,4253010,0,4253010,4253010,4252768,0
"7871","ECK4043-JW4011","qor",TRUE,"qorA","qorA",4253194,4253176,4254159,18,4254177,4254159,4253176,18
"7879","none-JW5717","none",TRUE,"yjbS","yjbS",4258755,4258737,4258940,18,4258958,4258940,4258737,18
"7883","none-JW4016","none",FALSE,"yjbQ","aphA",4259801,4260166,4260582,-365,4260028,4260055,4259342,-27
"7895","ECK4053-JW4022","yjcC",TRUE,"pdeC","pdeC",4265399,4265399,4266985,0,4266985,4266985,4265399,0
"7901","ECK4057-JW4025","yjcD",TRUE,"ghxP","ghxP",4268407,4268407,4269756,0,4269756,4269756,4268407,0
"7913","none-JW5719","none",FALSE,"nrfA","acs",4277410,4277692,4279128,-282,4277595,4277299,4275341,296
"7935","ECK4073-JW4041","yjcP",TRUE,"mdtP","mdtP",4289399,4289381,4290847,18,4290865,4290847,4289381,18
"7937","ECK4074-JW4042","yjcQ",TRUE,"mdtO","mdtO",4290862,4290844,4292895,18,4292913,4292895,4290844,18
"7939","ECK4075-JW4043","yjcR",TRUE,"mdtN","mdtN",4292913,4292895,4293926,18,4293944,4293926,4292895,18
"7941","none-JW5720","none",TRUE,"ytcA","ytcA",4293963,4293945,4294220,18,4294238,4294220,4293945,18
"7955","ECK4082-JW4050","rpiR",TRUE,"alsR","alsR",4301936,4301918,4302808,18,4302826,4302808,4301918,18
"7959","none-JW5725","none",FALSE,"yjdP","rpiB",4303645,4303685,4304014,-40,4303794,4303616,4303167,178
"7961","none-JW5726","none",TRUE,"yjdP","yjdP",4303727,4303685,4304014,42,4304053,4304014,4303685,39
"7993","ECK4100-JW4068","phnB",TRUE,"yjdN","yjdN",4315133,4315115,4315558,18,4315576,4315558,4315115,18
"7995","ECK4101-JW4069","phnA",TRUE,"yjdM","yjdM",4316234,4316216,4316551,18,4316569,4316551,4316216,18
"7997","none-JW5728","none",TRUE,"yjdM","yjdM",4316550,4316216,4316551,334,4316735,4316551,4316216,184
"7999","ECK4102-JW4070","yjdA",TRUE,"rdcA","rdcA",4316952,4316952,4319180,0,4319180,4319180,4316952,0
"8001","ECK4103-JW5729","yjcZ",TRUE,"rdcB","rdcB",4319177,4319177,4320055,0,4320055,4320055,4319177,0
"8037","ECK4121-JW4089","yjdK",TRUE,"ghoS","ghoS",4342401,4342401,4342697,0,4342697,4342697,4342401,0
"8039","ECK4122-JW5732","yjdO",TRUE,"ghoT","ghoT",4342725,4342725,4342898,0,4342898,4342898,4342725,0
"8043","ECK4124-JW4091","yjdL",TRUE,"dtpC","dtpC",4344789,4344771,4346228,18,4346246,4346228,4344771,18
"8053","ECK4130-JW5734","dipZ",TRUE,"dsbD","dsbD",4353180,4353162,4354859,18,4354877,4354859,4353162,18
"8073","ECK4140-JW4106","yjeK",TRUE,"epmB","epmB",4364464,4364446,4365474,18,4365492,4365474,4364446,18
"8081","ECK4144-JW5738","sugE",TRUE,"gdx","gdx",4366692,4366692,4367009,0,4367009,4367009,4366692,0
"8095","ECK4151-JW4116","poxA",TRUE,"epmA","epmA",4372460,4372460,4373437,0,4373437,4373437,4372460,0
"8103","ECK4155-JW4120","yjeP",TRUE,"mscM","mscM",4375882,4375864,4379187,18,4379205,4379187,4375864,18
"8111","ECK4162-JW4124","yjeS",TRUE,"queG","queG",4382763,4382745,4383884,18,4383902,4383884,4382745,18
"8113","ECK4163-JW4125","yjeF",TRUE,"nnr","nnr",4383883,4383883,4385430,0,4385403,4385430,4383883,-27
"8115","ECK4164-JW4126","yjeE",TRUE,"tsaE","tsaE",4385402,4385402,4385863,0,4385863,4385863,4385402,0
"8135","ECK4174-JW4136","yjeB",TRUE,"nsrR","nsrR",4396007,4396007,4396432,0,4396432,4396432,4396007,0
"8157","ECK4185-JW5743","yjfO",TRUE,"bsmA","bsmA",4406276,4406258,4406587,18,4406605,4406587,4406258,18
"8189","ECK4201-JW4163","ytfA",TRUE,"BW25113_RS21850","BW25113_RS21850",4417586,4417511,4417912,75,4417912,4417912,4417511,0
"8201","ECK4207-JW4169","ytfG",TRUE,"qorB","qorB",4422999,4422981,4423841,18,4423859,4423841,4422981,18
"8215","ECK4214-JW4177","ytfL",TRUE,"paeA","paeA",4429707,4429689,4431032,18,4431050,4431032,4429689,18
"8219","ECK4216-JW4179","ytfM",TRUE,"tamA","tamA",4432199,4432199,4433932,0,4433932,4433932,4432199,0
"8221","ECK4217-JW4180","ytfN",TRUE,"tamB","tamB",4433929,4433929,4437708,0,4437708,4437708,4433929,0
"8225","ECK4219-JW4182","yzfA",TRUE,"ytfP","ytfP",4437811,4437711,4438052,100,4438080,4438052,4437711,28
"8233","none-JW5751","none",FALSE,"ytfQ","ppa",4439499,4439779,4440735,-280,4439624,4439469,4438939,155
"8249","ECK4230-JW4194","pmbA",TRUE,"tldE","tldE",4447776,4447776,4449128,0,4449128,4449128,4447776,0
"8265","ECK4238-JW5755","yjgF",TRUE,"ridA","ridA",4460362,4460344,4460730,18,4460748,4460730,4460344,18
"8275","ECK4243-JW4207","yjgI",TRUE,"bdcA","bdcA",4463175,4463157,4463870,18,4463888,4463870,4463157,18
"8277","ECK4244-JW4208","yjgJ",TRUE,"bdcR","bdcR",4463941,4463941,4464534,0,4464534,4464534,4463941,0
"8279","ECK4245-JW5756","yjgK",TRUE,"tabA","tabA",4464679,4464679,4465131,0,4465131,4465131,4464679,0
"8285","ECK4248-JW4212","yjgD",TRUE,"rraB","rraB",4468290,4468290,4468706,0,4468706,4468706,4468290,0
"8297","ECK4254-JW4218","yjgP",TRUE,"lptF","lptF",4476035,4476035,4477135,0,4477135,4477135,4476035,0
"8299","ECK4255-JW5760","yjgQ",TRUE,"lptG","lptG",4477135,4477135,4478217,0,4478217,4478217,4477135,0
"8313","ECK4262-JW5761","yjgB",TRUE,"ahr","ahr",4485025,4485007,4486026,18,4486044,4486026,4485007,18
"8315","ECK4264-JW4227","intB",TRUE,"BW25113_RS22170","BW25113_RS22170",4486567,4486492,4487757,75,4487757,4487757,4486492,0
"8317","ECK4265-JW4233","yjgW",FALSE,"BW25113_RS23025","BW25113_RS22180",4489416,4489410,4490590,6,4489751,4489317,4488089,434
"8319","ECK4266-JW5763","yjgX",FALSE,"BW25113_RS23025","BW25113_RS22180",4489512,4489410,4490590,102,4489754,4489317,4488089,437
"8321","ECK4266-JW4234","yjgX",TRUE,"BW25113_RS23025","BW25113_RS23025",4489878,4489410,4490590,468,4490324,4490590,4489410,-266
"8323","ECK4266-JW5764","yjgX",TRUE,"BW25113_RS23025","BW25113_RS23025",4490267,4489410,4490590,857,4490626,4490590,4489410,36
"8325","none-JW5765","none",FALSE,"BW25113_RS24825","BW25113_RS23025",4490623,4491177,4491406,-554,4490853,4490590,4489410,263
"8327","ECK4267-JW4236","yjgZ",TRUE,"BW25113_RS24825","BW25113_RS24825",4491077,4491177,4491406,-100,4491406,4491406,4491177,0
"8329","none-JW5766","none",FALSE,"insG","BW25113_RS24825",4491749,4491920,4493266,-171,4491892,4491406,4491177,486
"8331","ECK4269-JW5768","yjhB",TRUE,"nanX","nanX",4493875,4493875,4495092,0,4495092,4495092,4493875,0
"8333","ECK4270-JW5769","yjhC",TRUE,"nanY","nanY",4495104,4495104,4496222,0,4496222,4496222,4495104,0
"8335","ECK4271-JW5770","yjhD",TRUE,"BW25113_RS22225","BW25113_RS22225",4496461,4496443,4496700,18,4496691,4496700,4496443,-9
"8337","ECK4272-JW4242","yjhE",TRUE,"BW25113_RS25825","BW25113_RS25825",4496678,4496690,4496926,-12,4496926,4496926,4496690,0
"8339","ECK4276-JW4246","yjhV",TRUE,"BW25113_RS25830","BW25113_RS25830",4499537,4499693,4499950,-156,4499950,4499950,4499693,0
"8383","ECK4298-JW5968","yjhX",TRUE,"topAI","topAI",4523631,4523613,4523870,18,4523888,4523870,4523613,18
"8387","ECK4300-JW4272","yjhS",TRUE,"nanS","nanS",4526449,4526431,4527411,18,4527429,4527411,4526431,18
"8389","ECK4301-JW5777","yjhT",TRUE,"nanM","nanM",4527494,4527476,4528582,18,4528600,4528582,4527476,18
"8391","ECK4302-JW5778","yjhA",TRUE,"nanC","nanC",4528620,4528602,4529318,18,4529336,4529318,4528602,18
"8417","none-JW5781","none",FALSE,"uxuR","uxuB",4544218,4544393,4545166,-175,4544412,4544178,4542718,234
"8423","ECK4317-JW5782","yjiD",TRUE,"iraD","iraD",4546810,4546810,4547202,0,4547202,4547202,4546810,0
"8425","ECK4318-JW4290","yjiE",TRUE,"hypT","hypT",4547213,4547195,4548106,18,4548124,4548106,4547195,18
"8439","none-JW4296","none",TRUE,"ytiA","ytiA",4553503,4553485,4553742,18,4553760,4553742,4553485,18
"8447","ECK4328-JW4300","yjiO",TRUE,"mdtM","mdtM",4557122,4557104,4558336,18,4558354,4558336,4557104,18
"8449","ECK4329-JW5953","yjiP",TRUE,"BW25113_RS25845","BW25113_RS25845",4558815,4558815,4559735,0,4559126,4559735,4558815,-609
"8451","ECK4330-JW4302","yjiQ",TRUE,"BW25113_RS25845","BW25113_RS25845",4559175,4558815,4559735,360,4559735,4559735,4558815,0
"8459","ECK4334-JW5954","yjiV",TRUE,"BW25113_RS22615","BW25113_RS22615",4564336,4563736,4566672,600,4566672,4566672,4563736,0
"8465","ECK4337-JW4310","yjiW",TRUE,"symE","symE",4569334,4569316,4569657,18,4569732,4569657,4569316,75
"8479","ECK4344-JW5791","yjiY",TRUE,"btsT","btsT",4578964,4578946,4581096,18,4581114,4581096,4578946,18
"8483","ECK4346-JW4319","yjiZ",TRUE,"lgoT","lgoT",4583196,4583178,4584539,18,4584557,4584539,4583178,18
"8485","ECK4347-JW5792","yjjM",TRUE,"lgoR","lgoR",4584772,4584754,4585668,18,4585686,4585668,4584754,18
"8487","ECK4348-JW5793","yjjN",TRUE,"lgoD","lgoD",4585807,4585807,4586829,0,4586829,4586829,4585807,0
"8489","ECK4349-JW5794","mdoB",TRUE,"opgB","opgB",4586985,4586967,4589258,18,4589276,4589258,4586967,18
"8529","none-JW5799","none",FALSE,"deoC","yjjI",4606934,4607140,4607919,-206,4607035,4606882,4605332,153
"8551","ECK4383-JW4354","yjjK",TRUE,"ettA","ettA",4618690,4618672,4620339,18,4620357,4620339,4618672,18
