"","id","gene","flag","first_pos","second_pos","length","quality","essentiel","init"
"1","ECK0001-JW4367","thrL",99,193,235,42,"50M","False","f"
"3","ECK0002-JW0001","thrA",99,340,2779,2439,"50M","False","f"
"5","ECK0003-JW0002","thrB",99,2804,3713,909,"50M","False","f"
"7","ECK0004-JW0003","thrC",99,3737,5000,1263,"50M","False","f"
"9","ECK0005-JW0004","yaaX",99,5237,5510,273,"50M","False","f"
"11","ECK0006-JW0005","yaaA",99,5704,6457,753,"50M","False","r"
"13","ECK0007-JW0006","yaaJ",99,6550,7957,1407,"50M","False","r"
"15","ECK0008-JW0007","talB",99,8241,9171,930,"50M","False","f"
"17","ECK0009-JW0008","mog",99,9309,9873,564,"50M","False","f"
"19","ECK0010-JW0009","yaaH",99,9949,10492,543,"50M","False","r"
"21","ECK0011-JW0010","yaaW",99,10664,11354,690,"50M","False","r"
"23","ECK0012-JW5001","htgA",99,10833,11295,462,"50M","False","f"
"25","ECK0013-JW0012","yaaI",99,11403,11784,381,"50M","False","r"
"27","ECK0014-JW0013","dnaK",99,12166,14059,1893,"50M","False","f"
"29","ECK0015-JW0014","dnaJ",99,14171,15278,1107,"50M","False","f"
"31","ECK0017-JW5002","hokC",99,16772,16901,129,"50M","False","r"
"33","ECK0020-JW0018","nhaA",99,17492,18635,1143,"50M","False","f"
"35","ECK0021-JW0019","nhaR",99,18718,19600,882,"50M","False","f"
"37","ECK0024-JW0022","rpsT",99,20836,21076,240,"50M","False","r"
"39","ECK0025-JW5003","yaaY",99,21184,21379,195,"50M","False","f"
"41","ECK0026-JW0023","ribF",99,21410,22328,918,"50M","False","f"
"43","ECK0027-JW0024","ileS",99,22394,25187,2793,"50M","False","f"
"45","ECK0028-JW0025","lspA",99,25210,25681,471,"50M","False","f"
"47","ECK0029-JW0026","fkpB",99,25829,26255,426,"50M","False","f"
"49","ECK0030-JW0027","ispH",99,26280,27207,927,"50M","False","f"
"51","ECK0031-JW0028","rihC",99,27296,28187,891,"50M","False","f"
"53","ECK0032-JW0029","dapB",99,28377,29175,798,"50M","False","f"
"55","ECK0033-JW0030","carA",99,29654,30779,1125,"50M","False","f"
"57","ECK0034-JW0031","carB",99,30820,34018,3198,"50M","False","f"
"59","none-JW0032","none",99,34107,34263,156,"50M","False","r"
"61","ECK0035-JW0033","caiF",99,34303,34675,372,"50M","False","f"
"63","ECK0036-JW5004","caiE",99,34802,35369,567,"50M","False","r"
"65","ECK0037-JW0035","caiD",99,35398,36268,870,"50M","False","r"
"67","ECK0038-JW0036","caiC",99,36292,37837,1545,"50M","False","r"
"69","ECK0039-JW0037","caiB",99,37919,39113,1194,"50M","False","r"
"71","ECK0040-JW0038","caiA",99,39265,40384,1119,"50M","False","r"
"73","ECK0041-JW0039","caiT",99,40438,41929,1491,"50M","False","r"
"75","ECK0042-JW0040","fixA",99,42406,43153,747,"50M","False","f"
"77","ECK0043-JW0041","fixB",99,43191,44109,918,"50M","False","f"
"79","ECK0044-JW0042","fixC",99,44183,45446,1263,"50M","False","f"
"81","ECK0045-JW0043","fixX",99,45466,45730,264,"50M","False","f"
"83","ECK0046-JW0044","yaaU",99,45810,47118,1308,"50M","False","f"
"85","ECK0047-JW0045","kefF",99,47249,47756,507,"50M","False","f"
"87","ECK0048-JW0046","kefC",99,47772,49611,1839,"50M","False","f"
"89","ECK0049-JW0047","folA",99,49826,50282,456,"50M","False","f"
"91","ECK0050-JW0048","apaH",99,50401,51220,819,"50M","False","r"
"93","ECK0051-JW0049","apaG",99,51250,51604,354,"50M","False","r"
"95","ECK0052-JW0050","ksgA",99,51630,52428,798,"50M","False","r"
"97","ECK0053-JW0051","pdxA",99,52448,53414,966,"50M","False","r"
"99","ECK0054-JW0052","surA",99,53437,54700,1263,"50M","False","r"
"101","ECK0055-JW0053","imp",99,54776,57107,2331,"50M","False","r"
"103","ECK0056-JW0054","djlA",99,57367,58159,792,"50M","False","f"
"105","ECK0057-JW0055","yabP",99,58477,59104,627,"50M","False","f"
"107","ECK0058-JW0056","yabQ",99,59124,59259,135,"50M","False","f"
"109","ECK0059-JW0057","rluA",99,59708,60344,636,"50M","False","r"
"111","ECK0060-JW0058","hepA",99,60379,63262,2883,"50M","False","r"
"113","ECK0061-JW0059","polB",99,63450,65778,2328,"50M","False","r"
"115","ECK0065-JW0063","araC",99,66877,67732,855,"50M","False","f"
"117","ECK0066-JW5005","yabI",99,67892,68582,690,"50M","False","f"
"119","ECK0067-JW0065","thiQ",99,68737,69412,675,"50M","False","r"
"121","ECK0068-JW0066","thiP",99,69419,71006,1587,"50M","False","r"
"123","ECK0069-JW0067","tbpA",99,71005,71965,960,"50M","False","r"
"125","ECK0070-JW0068","sgrR",99,72152,73784,1632,"50M","False","r"
"127","ECK0072-JW0069","setA",99,74111,75266,1155,"50M","False","f"
"129","ECK0073-JW0070","leuD",99,75356,75938,582,"50M","False","r"
"131","ECK0074-JW0071","leuC",99,75972,77349,1377,"50M","False","r"
"133","ECK0075-JW5807","leuB",99,77375,78446,1071,"50M","False","r"
"135","ECK0076-JW0073","leuA",99,78466,80014,1548,"50M","False","r"
"137","ECK0077-JW0074","leuL",99,80130,80193,63,"50M","False","r"
"139","ECK0078-JW0075","leuO",99,80858,81779,921,"50M","False","f"
"141","ECK0079-JW0076","ilvI",99,82120,83821,1701,"50M","False","f"
"143","ECK0080-JW0077","ilvH",99,83847,84315,468,"50M","False","f"
"145","ECK0081-JW0078","fruR",99,84518,85499,981,"50M","False","f"
"147","ECK0082-JW0079","mraZ",99,86124,86559,435,"50M","False","f"
"149","ECK0083-JW0080","mraW",99,86584,87502,918,"50M","False","f"
"151","ECK0084-JW0081","ftsL",99,87522,87864,342,"50M","False","f"
"153","ECK0085-JW0082","ftsI",99,87903,89646,1743,"50M","False","f"
"155","ECK0086-JW0083","murE",99,89656,91120,1464,"50M","False","f"
"157","ECK0087-JW0084","murF",99,91140,92475,1335,"50M","False","f"
"159","ECK0088-JW0085","mraY",99,92492,93551,1059,"50M","False","f"
"161","ECK0089-JW0086","murD",99,93577,94870,1293,"50M","False","f"
"163","ECK0090-JW0087","ftsW",99,94893,96114,1221,"50M","False","f"
"165","ECK0091-JW0088","murG",99,96134,97178,1044,"50M","False","f"
"167","ECK0092-JW0089","murC",99,97255,98707,1452,"50M","False","f"
"169","ECK0093-JW0090","ddlB",99,98729,99620,891,"50M","False","f"
"171","ECK0094-JW0091","ftsQ",99,99645,100452,807,"50M","False","f"
"173","ECK0095-JW0092","ftsA",99,100472,101711,1239,"50M","False","f"
"175","ECK0096-JW0093","ftsZ",99,101795,102923,1128,"50M","False","f"
"177","ECK0097-JW0094","lpxC",99,103047,103941,894,"50M","False","f"
"179","ECK0098-JW5007","secM",99,104195,104684,489,"50M","False","f"
"181","ECK0099-JW0096","secA",99,104769,107451,2682,"50M","False","f"
"183","ECK0100-JW0097","mutT",99,107534,107900,366,"50M","False","f"
"185","ECK0101-JW5008","yacG",99,108157,108286,129,"50M","False","r"
"187","ECK0102-JW0099","yacF",99,108364,109084,720,"50M","False","r"
"189","ECK0103-JW0100","coaE",99,109107,109704,597,"50M","False","r"
"191","ECK0104-JW0101","guaC",99,109934,110954,1020,"50M","False","f"
"193","ECK0105-JW0102","hofC",99,111030,112209,1179,"50M","False","r"
"195","ECK0106-JW0103","hofB",99,112222,113584,1362,"50M","False","r"
"197","ECK0107-JW0104","ppdD",99,113617,114034,417,"50M","False","r"
"199","ECK0108-JW0105","nadC",99,114260,115130,870,"50M","False","r"
"201","ECK0109-JW0106","ampD",99,115223,115751,528,"50M","False","f"
"203","ECK0110-JW0107","ampE",99,115771,116602,831,"50M","False","f"
"205","ECK0111-JW0108","aroP",99,116686,118036,1350,"50M","False","r"
"207","ECK0112-JW0109","pdhR",99,118582,119323,741,"50M","False","f"
"209","ECK0113-JW0110","aceE",99,119507,122147,2640,"50M","False","f"
"211","ECK0114-JW0111","aceF",99,122185,124054,1869,"50M","False","f"
"213","ECK0115-JW0112","lpd",99,124402,125803,1401,"50M","False","f"
"215","ECK0116-JW0113","yacH",99,125915,127745,1830,"50M","False","r"
"217","ECK0117-JW0114","acnB",99,128105,130679,2574,"50M","False","f"
"219","ECK0118-JW0115","yacL",99,130878,131217,339,"50M","False","f"
"221","ECK0119-JW0116","speD",99,131296,132067,771,"50M","False","r"
"223","ECK0120-JW0117","speE",99,132106,132949,843,"50M","False","r"
"225","ECK0121-JW0118","yacC",99,133078,133402,324,"50M","False","r"
"227","ECK0122-JW0119","cueO",99,133573,135100,1527,"50M","False","f"
"229","ECK0123-JW0120","gcd",99,135343,137710,2367,"50M","False","r"
"231","ECK0124-JW5009","hpt",99,137921,138434,513,"50M","False","f"
"233","ECK0125-JW0122","can",99,138516,139155,639,"50M","False","r"
"235","ECK0126-JW0123","yadG",99,139269,140172,903,"50M","False","f"
"237","ECK0127-JW0124","yadH",99,140192,140939,747,"50M","False","f"
"239","ECK0128-JW0125","yadI",99,141067,141484,417,"50M","False","f"
"241","ECK0129-JW0126","yadE",99,141571,142777,1206,"50M","False","f"
"243","ECK0130-JW0127","panD",99,142822,143179,357,"50M","False","r"
"245","ECK0131-JW5010","yadD",99,143509,144337,828,"50M","False","f"
"247","ECK0132-JW0129","panC",99,144452,145280,828,"50M","False","r"
"249","ECK0133-JW0130","panB",99,145315,146086,771,"50M","False","r"
"251","ECK0134-JW0131","yadC",99,146223,147438,1215,"50M","False","r"
"253","ECK0135-JW0132","yadK",99,147511,148084,573,"50M","False","r"
"255","ECK0136-JW0133","yadL",99,148134,148716,582,"50M","False","r"
"257","ECK0137-JW0134","yadM",99,148751,149297,546,"50M","False","r"
"259","ECK0138-JW0135","htrE",99,149337,151911,2574,"50M","False","r"
"261","ECK0139-JW0136","ecpD",99,151969,152686,717,"50M","False","r"
"263","ECK0140-JW0137","yadN",99,152807,153368,561,"50M","False","r"
"265","ECK0141-JW0138","folK",99,153761,154217,456,"50M","False","r"
"267","ECK0142-JW5808","pcnB",99,154237,155632,1395,"50M","False","r"
"269","ECK0143-JW5892","yadB",99,155694,156597,903,"50M","False","r"
"271","ECK0144-JW0141","dksA",99,156657,157089,432,"50M","False","r"
"273","ECK0145-JW0142","sfsA",99,157290,157971,681,"50M","False","r"
"275","ECK0146-JW5011","ligT",99,158009,158516,507,"50M","False","r"
"277","ECK0147-JW0144","hrpB",99,158595,161001,2406,"50M","False","f"
"279","ECK0148-JW0145","mrcB",99,161220,163731,2511,"50M","False","f"
"281","ECK0149-JW0146","fhuA",99,163974,166194,2220,"50M","False","f"
"283","ECK0150-JW0147","fhuC",99,166268,167042,774,"50M","False","f"
"285","ECK0151-JW0148","fhuD",99,167065,167932,867,"50M","False","f"
"287","ECK0152-JW0149","fhuB",99,167952,169911,1959,"50M","False","f"
"289","ECK0153-JW0150","hemL",99,170110,171367,1257,"50M","False","r"
"291","ECK0154-JW5012","clcA",99,171708,172995,1287,"50M","False","f"
"293","ECK0155-JW0152","yadR",99,173100,173421,321,"50M","False","f"
"295","ECK0156-JW0153","yadS",99,173509,174109,600,"50M","False","r"
"297","ECK0157-JW0154","btuF",99,174170,174947,777,"50M","False","r"
"299","ECK0158-JW0155","pfs",99,174963,175638,675,"50M","False","r"
"301","ECK0159-JW0156","dgt",99,175727,177221,1494,"50M","False","f"
"303","ECK0160-JW0157","degP",99,177374,178775,1401,"50M","False","f"
"305","ECK0161-JW5013","cdaR",99,178935,180087,1152,"50M","False","f"
"307","ECK0162-JW0159","yaeH",99,180217,180580,363,"50M","False","r"
"309","ECK0163-JW5014","yaeI",99,180765,181275,510,"50M","False","r"
"311","ECK0164-JW0161","dapD",99,181631,182432,801,"50M","False","r"
"313","ECK0165-JW0162","glnD",99,182486,185135,2649,"50M","False","r"
"315","ECK0166-JW0163","map",99,185220,185991,771,"50M","False","r"
"317","ECK0168-JW0164","rpsB",99,186364,187066,702,"50M","False","f"
"319","ECK0169-JW0165","tsf",99,187347,188175,828,"50M","False","f"
"321","ECK0170-JW0166","pyrH",99,188345,189047,702,"50M","False","f"
"323","ECK0171-JW0167","frr",99,189362,189896,534,"50M","False","f"
"325","ECK0172-JW0168","dxr",99,190011,191184,1173,"50M","False","f"
"327","ECK0173-JW0169","ispU",99,191393,192131,738,"50M","False","f"
"329","ECK0174-JW5810","cdsA",99,192167,193001,834,"50M","False","f"
"331","ECK0175-JW0171","yaeL",99,193036,194365,1329,"50M","False","f"
"333","ECK0176-JW0172","yaeT",99,194418,196827,2409,"50M","False","f"
"335","none-JW5015","none",99,196851,196938,87,"50M","False","f"
"337","ECK0177-JW0173","hlpA",99,196972,197434,462,"50M","False","f"
"339","ECK0178-JW0174","lpxD",99,197461,198463,1002,"50M","False","f"
"341","ECK0179-JW0175","fabZ",99,198591,199023,432,"50M","False","f"
"343","ECK0180-JW0176","lpxA",99,199050,199815,765,"50M","False","f"
"345","ECK0181-JW0177","lpxB",99,199838,200963,1125,"50M","False","f"
"347","ECK0182-JW0178","rnhB",99,200983,201556,573,"50M","False","f"
"349","ECK0183-JW0179","dnaE",97,201616,205075,3459,"50M","False","f"
"351","ECK0184-JW0180","accA",99,205111,206047,936,"50M","False","f"
"353","ECK0185-JW0181","ldcC",99,206169,208287,2118,"50M","False","f"
"355","ECK0186-JW0182","yaeR",99,208367,208733,366,"50M","False","f"
"357","ECK0187-JW0183","tilS",99,208821,210096,1275,"50M","False","f"
"359","ECK0188-JW0184","rof",99,210186,210417,231,"50M","False","r"
"361","ECK0189-JW0185","yaeP",99,210433,210610,177,"50M","False","r"
"363","ECK0190-JW0186","yaeQ",99,210781,211303,522,"50M","False","f"
"365","ECK0191-JW0187","yaeJ",99,211323,211722,399,"50M","False","f"
"367","ECK0192-JW0188","nlpE",99,211759,212446,687,"50M","False","f"
"369","ECK0193-JW5016","yaeF",99,212687,213542,855,"50M","False","r"
"371","ECK0194-JW0190","proS",99,213565,215260,1695,"50M","False","r"
"373","ECK0195-JW0191","yaeB",99,215395,216079,684,"50M","False","r"
"375","ECK0196-JW0192","rcsF",99,216099,216480,381,"50M","False","r"
"377","ECK0197-JW0193","metQ",99,216621,217413,792,"50M","False","r"
"379","ECK0198-JW0194","metI",99,217476,218106,630,"50M","False","r"
"381","ECK0199-JW0195","metN",99,218122,219130,1008,"50M","False","r"
"383","ECK0200-JW0196","gmhB",99,219323,219875,552,"50M","False","f"
"385","ECK0207-JW0197","dkgB",99,225657,226437,780,"50M","False","f"
"387","ECK0208-JW0198","yafC",99,226475,227366,891,"50M","False","r"
"389","ECK0209-JW5017","yafD",99,227633,228389,756,"50M","False","f"
"391","ECK0210-JW0200","yafE",99,228416,229016,600,"50M","False","f"
"393","ECK0211-JW5018","mltD",99,229105,230440,1335,"50M","False","r"
"395","ECK0212-JW0202","gloB",99,230535,231267,732,"50M","False","r"
"397","ECK0213-JW0203","yafS",99,231306,232005,699,"50M","False","f"
"399","ECK0214-JW0204","rnhA",99,232043,232487,444,"50M","False","r"
"401","ECK0215-JW0205","dnaQ",99,232557,233265,708,"50M","False","f"
"403","ECK0217-JW0206","yafT",99,233825,234587,762,"50M","False","f"
"405","ECK0218-JW0207","yafU",99,235254,235569,315,"50M","False","r"
"407","ECK0219-JW0208","yafF",99,235680,235845,165,"50M","False","f"
"409","ECK0220-JW5019","yafV",99,235927,236683,756,"50M","False","r"
"411","ECK0221-JW0210","ivy",99,236833,237283,450,"50M","False","f"
"413","ECK0222-JW5020","fadE",99,237367,239866,2499,"50M","False","r"
"415","ECK0223-JW0212","lpcA",99,240033,240588,555,"50M","False","f"
"417","ECK0224-JW0213","yafJ",99,240817,241561,744,"50M","False","f"
"419","ECK0225-JW0214","yafK",99,241573,242290,717,"50M","False","r"
"421","ECK0226-JW0215","yafQ",99,242469,242724,255,"50M","False","r"
"423","ECK0227-JW0216","dinJ",99,242750,242987,237,"50M","False","r"
"425","ECK0228-JW0217","yafL",99,243202,243928,726,"50M","False","f"
"427","ECK0229-JW0218","yafM",99,244127,244601,474,"50M","False","f"
"429","ECK0230-JW5811","fhiA",99,244866,246582,1716,"50M","False","r"
"431","ECK0231-JW5812","mbhA",99,246532,247294,762,"50M","False","f"
"433","ECK0232-JW0221","dinB",99,247388,248420,1032,"50M","False","f"
"435","ECK0233-JW0222","yafN",99,248495,248765,270,"50M","False","f"
"437","ECK0234-JW0223","yafO",99,248791,249166,375,"50M","False","f"
"439","ECK0235-JW0224","yafP",99,249199,249628,429,"50M","False","f"
"441","ECK0236-JW0225","ykfJ",99,249957,250200,243,"50M","False","f"
"443","ECK0237-JW0226","prfH",99,250192,250669,477,"50M","False","f"
"445","ECK0238-JW0227","pepD",99,250767,252201,1434,"50M","False","r"
"447","ECK0239-JW0228","gpt",99,252467,252902,435,"50M","False","f"
"449","ECK0240-JW0229","frsA",99,253017,254238,1221,"50M","False","f"
"451","ECK0241-JW0230","crl",99,254319,254697,378,"50M","False","f"
"453","ECK0242-JW0231","phoE",99,254777,255809,1032,"50M","False","r"
"455","ECK0243-JW0232","proB",99,256102,257182,1080,"50M","False","f"
"457","ECK0244-JW0233","proA",99,257217,258447,1230,"50M","False","f"
"459","ECK0246-JW0234","ykfI",99,259060,259378,318,"50M","False","r"
"461","ECK0247-JW0235","yafW",99,259422,259716,294,"50M","False","r"
"463","ECK0248-JW5956","ykfH",99,259758,259956,198,"50M","False","r"
"465","ECK0249-JW0236","ykfG",99,259988,260441,453,"50M","False","r"
"467","ECK0250-JW5022","yafX",99,260480,261089,609,"50M","False","r"
"469","ECK0251-JW5023","ykfF",99,261036,261414,378,"50M","False","r"
"471","ECK0252-JW0239","ykfB",99,261352,261796,444,"50M","False","r"
"473","ECK0253-JW0240","yafY",99,261842,262676,834,"50M","False","r"
"475","none-JW0241","none",99,262285,262438,153,"50M","False","r"
"477","ECK0254-JW0242","yafZ",99,262916,263714,798,"50M","False","r"
"479","ECK0255-JW0243","ykfA",99,263829,264669,840,"50M","False","r"
"481","ECK0256-JW0244","perR",99,265021,265891,870,"50M","False","r"
"483","ECK0259-JW0247","insO",99,267544,267946,402,"50M","False","f"
"485","none-JW5025","none",99,268415,268514,99,"50M","False","f"
"487","ECK0260-JW5813","ykfC",99,268576,269683,1107,"50M","False","f"
"489","ECK0262-JW5027","mmuP",99,271039,272419,1380,"50M","False","f"
"491","ECK0263-JW0253","mmuM",99,272429,273338,909,"50M","False","f"
"493","ECK0264-JW0254","afuC",99,273488,274511,1023,"50M","False","r"
"495","ECK0265-JW0255","afuB",99,274546,274885,339,"50M","False","r"
"497","ECK0266-JW0258","ykgN",99,275756,276071,315,"50M","False","r"
"499","ECK0267-JW0259","yagB",99,276117,276444,327,"50M","False","r"
"501","ECK0268-JW0260","yagA",99,276561,277692,1131,"50M","False","r"
"503","ECK0269-JW0261","yagE",99,277971,278877,906,"50M","False","f"
"505","ECK0270-JW0262","yagF",99,278915,280859,1944,"50M","False","f"
"507","ECK0271-JW0263","yagG",99,281109,282468,1359,"50M","False","f"
"509","ECK0272-JW0264","yagH",99,282503,284090,1587,"50M","False","f"
"511","ECK0273-JW0265","yagI",99,284136,284871,735,"50M","False","r"
"513","ECK0274-JW0266","argF",99,285033,286014,981,"50M","False","r"
"515","none-JW5028","none",99,286224,286329,105,"50M","False","f"
"517","ECK0275-JW0270","yagJ",99,287214,287922,708,"50M","False","f"
"519","ECK0276-JW0271","yagK",99,288054,288657,603,"50M","False","r"
"521","ECK0277-JW0272","yagL",99,288952,289627,675,"50M","False","r"
"523","ECK0278-JW0273","yagM",99,289677,290508,831,"50M","False","r"
"525","none-JW5029","none",99,290650,290851,201,"50M","False","r"
"527","ECK0279-JW0274","yagN",99,290871,291288,417,"50M","False","r"
"529","ECK0280-JW0275","intF",99,291428,292805,1377,"50M","False","r"
"531","ECK0281-JW0276","yagP",99,293113,293500,387,"50M","False","r"
"533","ECK0282-JW0277","yagQ",99,293502,294435,933,"50M","False","r"
"535","ECK0283-JW0278","yagR",99,294468,296643,2175,"50M","False","r"
"537","ECK0284-JW0279","yagS",99,296663,297596,933,"50M","False","r"
"539","ECK0285-JW0280","yagT",99,297616,298282,666,"50M","False","r"
"541","ECK0286-JW0281","yagU",99,298705,299296,591,"50M","False","f"
"543","ECK0287-JW0282","ykgJ",99,299585,299891,306,"50M","False","r"
"545","ECK0288-JW5030","yagV",99,300227,300959,732,"50M","False","r"
"547","ECK0289-JW0284","yagW",99,300906,302526,1620,"50M","False","r"
"549","ECK0290-JW0285","yagX",99,302539,305041,2502,"50M","False","r"
"551","ECK0291-JW0286","yagY",99,305090,305735,645,"50M","False","r"
"553","ECK0292-JW0287","yagZ",99,305816,306380,564,"50M","False","r"
"555","ECK0293-JW5031","ykgK",99,306478,306706,228,"50M","False","r"
"557","none-JW5032","none",99,307654,307741,87,"50M","False","f"
"559","ECK0294-JW5033","ykgL",99,307820,308030,210,"50M","False","f"
"561","ECK0295-JW5034","ykgM",99,308106,308223,117,"50M","False","r"
"563","ECK0296-JW5035","ykgM",99,308246,308486,240,"50M","False","r"
"565","ECK0297-JW0291","eaeH",99,310071,310935,864,"50M","False","f"
"567","ECK0300-JW5037","ykgA",99,312182,312878,696,"50M","False","r"
"569","ECK0301-JW5038","ykgB",99,313458,314037,579,"50M","False","r"
"571","ECK0302-JW5039","ykgI",99,314063,314291,228,"50M","False","r"
"573","ECK0303-JW5040","ykgC",99,314408,315710,1302,"50M","False","r"
"575","ECK0304-JW0298","ykgD",99,315941,316772,831,"50M","False","f"
"577","ECK0305-JW5041","ykgE",99,317388,318018,630,"50M","False","f"
"579","ECK0306-JW0300","ykgF",99,318052,319456,1404,"50M","False","f"
"581","ECK0307-JW5042","ykgG",99,319478,320144,666,"50M","False","f"
"583","ECK0308-JW0302","ykgH",99,320428,321073,645,"50M","False","r"
"585","ECK0309-JW0303","betA",99,321309,322956,1647,"50M","False","r"
"587","ECK0310-JW0304","betB",99,322993,324442,1449,"50M","False","r"
"589","ECK0311-JW0305","betI",99,324479,325043,564,"50M","False","r"
"591","ECK0312-JW0306","betT",99,325177,327187,2010,"50M","False","f"
"593","ECK0313-JW0307","yahA",99,328085,329150,1065,"50M","False","f"
"595","ECK0314-JW0308","yahB",99,329233,330142,909,"50M","False","r"
"597","ECK0315-JW0309","yahC",99,330257,330731,474,"50M","False","r"
"599","ECK0316-JW0310","yahD",99,330994,331576,582,"50M","False","f"
"601","ECK0317-JW0311","yahE",99,331639,332479,840,"50M","False","f"
"603","ECK0318-JW0312","yahF",99,332492,334016,1524,"50M","False","f"
"605","ECK0319-JW0313","yahG",99,334039,335434,1395,"50M","False","f"
"607","ECK0320-JW5893","yahH",99,335378,335780,402,"50M","False","f"
"609","ECK0321-JW0315","yahI",99,335879,336806,927,"50M","False","f"
"611","ECK0322-JW0316","yahJ",99,336839,338198,1359,"50M","False","f"
"613","ECK0323-JW0317","yahK",99,338598,339624,1026,"50M","False","f"
"615","ECK0324-JW0318","yahL",99,339890,340682,792,"50M","False","f"
"617","ECK0325-JW5044","yahM",99,341088,341340,252,"50M","False","f"
"619","ECK0326-JW0320","yahN",99,341398,342046,648,"50M","False","r"
"621","ECK0327-JW0321","yahO",99,342198,342450,252,"50M","False","f"
"623","ECK0328-JW0322","prpR",99,342589,344152,1563,"50M","False","r"
"625","ECK0329-JW0323","prpB",99,344396,345263,867,"50M","False","f"
"627","ECK0330-JW0324","prpC",99,345726,346872,1146,"50M","False","f"
"629","ECK0331-JW0325","prpD",99,346929,348357,1428,"50M","False","f"
"631","ECK0332-JW0326","prpE",99,348420,350283,1863,"50M","False","f"
"633","ECK0333-JW0327","codB",99,350636,351872,1236,"50M","False","f"
"635","ECK0334-JW0328","codA",99,351885,353145,1260,"50M","False","f"
"637","ECK0335-JW5894","cynR",99,353523,354399,876,"50M","False","r"
"639","ECK0336-JW0330","cynT",99,354513,355149,636,"50M","False","f"
"641","ECK0337-JW0331","cynS",99,355203,355650,447,"50M","False","f"
"643","ECK0338-JW0332","cynX",99,355706,356837,1131,"50M","False","f"
"645","ECK0339-JW0333","lacA",99,356981,357569,588,"50M","False","r"
"647","ECK0340-JW0334","lacY",99,357658,358888,1230,"50M","False","r"
"649","ECK0342-JW0336","lacI",99,360702,361741,1039,"20S30M","False","r"
"651","ECK0343-JW0337","mhpR",99,361841,362765,924,"50M","False","r"
"653","ECK0344-JW0338","mhpA",99,362847,364488,1641,"50M","False","f"
"655","ECK0345-JW0339","mhpB",99,364513,365434,921,"50M","False","f"
"657","ECK0346-JW0340","mhpC",99,365460,367541,2081,"50M","False","f"
"659","ECK0347-JW0341","mhpD",99,367574,368360,786,"50M","False","f"
"661","ECK0348-JW0342","mhpF",99,368380,369307,927,"50M","False","f"
"663","ECK0349-JW0343","mhpE",99,369327,370317,990,"50M","False","f"
"665","ECK0350-JW5046","mhpT",99,370918,372106,1188,"50M","False","f"
"667","ECK0351-JW0345","yaiL",99,372231,372747,516,"50M","False","f"
"669","none-JW5047","none",99,372792,372876,84,"50M","False","f"
"671","ECK0352-JW0346","frmB",99,373012,373822,810,"50M","False","r"
"673","ECK0353-JW0347","frmA",99,373939,375025,1086,"50M","False","r"
"675","ECK0354-JW0348","frmR",99,375083,375335,252,"50M","False","r"
"677","ECK0355-JW0349","yaiO",99,375546,376296,750,"50M","False","r"
"679","ECK0356-JW0350","yaiX",99,376321,376513,192,"50M","False","r"
"681","ECK0359-JW5814","yaiF",99,377981,378344,363,"50M","False","r"
"683","ECK0360-JW0355","yaiP",99,378216,379389,1173,"50M","False","r"
"685","ECK0361-JW0356","yaiS",99,379536,380070,534,"50M","False","r"
"687","ECK0362-JW0357","tauA",99,380691,381630,939,"50M","False","f"
"689","ECK0363-JW0358","tauB",99,381666,382410,744,"50M","False","f"
"691","ECK0364-JW0359","tauC",99,382430,383234,804,"50M","False","f"
"693","ECK0365-JW0360","tauD",99,383254,384082,828,"50M","False","f"
"695","ECK0366-JW0361","hemB",99,384230,385181,951,"50M","False","r"
"697","ECK0367-JW5049","ykiB",99,385374,385569,195,"50M","False","r"
"699","ECK0368-JW0362","yaiT",99,385710,387147,1437,"50M","False","f"
"701","ECK0369-JW5051","yaiU",99,388480,389854,1374,"50M","False","f"
"703","ECK0370-JW0366","yaiV",99,389920,390565,645,"50M","False","f"
"705","ECK0371-JW5052","ampH",99,390607,391741,1134,"50M","False","r"
"707","ECK0372-JW0368","sbmA",99,392098,393295,1197,"50M","False","f"
"709","ECK0373-JW0369","yaiW",99,393331,394402,1071,"50M","False","f"
"711","ECK0374-JW0370","yaiY",99,394502,394787,285,"50M","False","r"
"713","ECK0375-JW5053","yaiZ",99,394983,395241,258,"50M","False","f"
"715","ECK0376-JW0372","ddlA",99,395306,396377,1071,"50M","False","r"
"717","ECK0377-JW0373","yaiB",99,396845,397082,237,"50M","False","f"
"719","ECK0378-JW0374","phoA",99,397206,398598,1392,"50M","False","f"
"721","ECK0379-JW5054","psiF",99,398740,399037,297,"50M","False","f"
"723","ECK0380-JW0376","yaiC",99,399162,400254,1092,"50M","False","f"
"725","ECK0381-JW0377","proC",99,400312,401098,786,"50M","False","r"
"727","ECK0382-JW0378","yaiI",99,401223,401658,435,"50M","False","f"
"729","ECK0383-JW0379","aroL",99,401864,402365,501,"50M","False","f"
"731","ECK0384-JW0380","yaiA",99,402438,402606,168,"50M","False","f"
"733","ECK0385-JW0381","aroM",99,402887,403541,654,"50M","False","f"
"735","ECK0386-JW0382","yaiE",99,403636,403897,261,"50M","False","f"
"737","ECK0387-JW0383","ykiA",99,404128,404386,258,"50M","False","f"
"739","ECK0388-JW0384","rdgC",99,404585,405473,888,"50M","False","r"
"741","ECK0389-JW0385","mak",99,405603,406488,885,"50M","False","f"
"743","ECK0390-JW0386","araJ",99,406774,407935,1161,"50M","False","r"
"745","ECK0391-JW0387","sbcC",99,408084,411207,3123,"50M","False","r"
"747","ECK0392-JW0388","sbcD",99,411227,412406,1179,"50M","False","r"
"749","ECK0393-JW0389","phoB",99,412601,413267,666,"50M","False","f"
"751","ECK0394-JW0390","phoR",99,413348,414620,1272,"50M","False","f"
"753","ECK0395-JW0391","brnQ",99,415050,416346,1296,"50M","False","f"
"755","ECK0396-JW5055","proY",99,416445,417795,1350,"50M","False","f"
"757","ECK0397-JW0393","malZ",99,417974,419768,1794,"50M","False","f"
"759","ECK0398-JW0394","yajB",99,419814,420372,558,"50M","False","r"
"761","ECK0399-JW0395","queA",99,420470,421517,1047,"50M","False","f"
"763","ECK0400-JW0396","tgt",99,421596,422700,1104,"50M","False","f"
"765","ECK0401-JW0397","yajC",99,422746,423055,309,"50M","False","f"
"767","ECK0402-JW0398","secD",99,423106,424930,1824,"50M","False","f"
"769","ECK0403-JW0399","secF",99,424964,425912,948,"50M","False","f"
"771","ECK0404-JW0400","yajD",99,426064,426388,324,"50M","False","f"
"773","ECK0405-JW0401","tsx",99,426606,427467,861,"50M","False","r"
"775","ECK0406-JW5056","yajI",99,427789,428365,576,"50M","False","r"
"777","ECK0407-JW0403","ybaD",99,428461,428887,426,"50M","False","f"
"779","ECK0408-JW0404","ribD",99,428914,429994,1080,"50M","False","f"
"781","ECK0409-JW0405","ribE",99,430106,430553,447,"50M","False","f"
"783","ECK0410-JW0406","nusB",99,430596,430992,396,"50M","False","f"
"785","ECK0411-JW0407","thiL",99,431093,432026,933,"50M","False","f"
"787","ECK0412-JW0408","pgpA",99,432048,432543,495,"50M","False","f"
"789","ECK0413-JW0409","yajO",99,432638,433589,951,"50M","False","r"
"791","ECK0414-JW0410","dxs",99,433792,435631,1839,"50M","False","r"
"793","ECK0415-JW0411","ispA",99,435679,436555,876,"50M","False","r"
"795","ECK0416-JW0412","xseB",99,436578,436797,219,"50M","False","r"
"797","ECK0417-JW0413","thiI",99,437008,438433,1425,"50M","False","f"
"799","ECK0418-JW5057","yajL",99,438528,439095,567,"50M","False","r"
"801","ECK0419-JW0415","panE",99,439081,439969,888,"50M","False","r"
"803","ECK0420-JW5058","yajQ",99,439974,440610,636,"50M","False","f"
"805","ECK0421-JW5059","yajR",99,440779,442126,1347,"50M","False","r"
"807","ECK0422-JW0418","cyoE",99,442292,443159,867,"50M","False","r"
"809","ECK0423-JW0419","cyoD",99,443194,443500,306,"50M","False","r"
"811","ECK0424-JW0420","cyoC",99,443523,444114,591,"50M","False","r"
"813","ECK0425-JW0421","cyoB",99,444127,446095,1968,"50M","False","r"
"815","ECK0426-JW0422","cyoA",99,446140,447064,924,"50M","False","r"
"817","ECK0427-JW0423","ampG",99,447547,448999,1452,"50M","False","r"
"819","ECK0428-JW0424","yajG",99,449066,449621,555,"50M","False","r"
"821","ECK0429-JW5060","bolA",99,449898,450225,327,"50M","False","f"
"823","ECK0430-JW0426","tig",99,450592,451867,1275,"50M","False","f"
"825","ECK0431-JW0427","clpP",99,452136,452736,600,"50M","False","f"
"827","ECK0432-JW0428","clpX",99,452885,454136,1251,"50M","False","f"
"829","ECK0433-JW0429","lon",99,454347,456678,2331,"50M","False","f"
"831","ECK0434-JW0430","hupB",99,456910,457159,249,"50M","False","f"
"833","ECK0435-JW0431","ppiD",99,457374,459222,1848,"50M","False","f"
"835","ECK0436-JW0432","ybaV",99,459396,459744,348,"50M","False","f"
"837","ECK0437-JW0433","ybaW",99,459861,460236,375,"50M","False","f"
"839","ECK0438-JW0434","ybaX",99,460329,461001,672,"50M","False","r"
"841","ECK0439-JW0435","ybaE",99,461089,462766,1677,"50M","False","r"
"843","ECK0440-JW0436","cof",99,462871,463666,795,"50M","False","f"
"845","ECK0441-JW0437","ybaO",99,463842,464277,435,"50M","False","f"
"847","ECK0442-JW0438","mdlA",99,464330,466079,1749,"50M","False","f"
"849","ECK0443-JW5061","mdlB",99,466095,467853,1758,"50M","False","f"
"851","ECK0444-JW0440","glnK",99,468057,468372,315,"50M","False","f"
"853","ECK0445-JW0441","amtB",99,468425,469688,1263,"50M","False","f"
"855","ECK0446-JW0442","tesB",99,469778,470615,837,"50M","False","r"
"857","ECK0447-JW0443","ybaY",99,470838,471387,549,"50M","False","f"
"859","ECK0448-JW0444","ybaZ",99,471459,471825,366,"50M","False","r"
"861","ECK0450-JW0445","ybaA",99,472131,472461,330,"50M","False","f"
"863","ECK0451-JW5062","ylaB",99,472544,474077,1533,"50M","False","r"
"865","ECK0452-JW5063","ylaC",99,474258,474744,486,"50M","False","r"
"867","ECK0453-JW0448","maa",99,474844,475372,528,"50M","False","r"
"869","ECK0454-JW0449","hha",99,475567,475762,195,"50M","False","r"
"871","ECK0455-JW0450","ybaJ",99,475811,476162,351,"50M","False","r"
"873","ECK0456-JW0451","acrB",99,476731,479857,3126,"50M","False","r"
"875","ECK0457-JW0452","acrA",99,479903,481073,1170,"50M","False","r"
"877","ECK0458-JW0453","acrR",99,481220,481844,624,"50M","False","f"
"879","ECK0459-JW0454","kefA",99,481995,485334,3339,"50M","False","f"
"881","ECK0460-JW0455","ybaM",99,485587,485725,138,"50M","False","r"
"883","ECK0461-JW0456","priC",99,485762,486266,504,"50M","False","r"
"885","ECK0462-JW0457","ybaN",99,486341,486695,354,"50M","False","f"
"887","ECK0463-JW0458","apt",99,486871,487399,528,"50M","False","f"
"889","ECK0464-JW0459","dnaX",99,487551,489459,1908,"50M","False","f"
"891","ECK0465-JW0460","ybaB",99,489535,489841,306,"50M","False","f"
"893","ECK0466-JW0461","recR",99,489864,490446,582,"50M","False","f"
"895","ECK0467-JW0462","htpG",99,490579,492430,1851,"50M","False","f"
"897","ECK0468-JW0463","adk",99,492634,493255,621,"50M","False","f"
"899","ECK0469-JW0464","hemH",99,493514,494453,939,"50M","False","f"
"901","ECK0470-JW0465","aes",99,494491,495427,936,"50M","False","r"
"903","ECK0471-JW0466","gsk",99,495584,496865,1281,"50M","False","f"
"905","ECK0472-JW0467","ybaL",99,497039,498692,1653,"50M","False","r"
"907","ECK0473-JW0468","fsr",99,498953,500150,1197,"50M","False","r"
"909","none-JW5064","none",99,500191,500353,162,"50M","False","f"
"911","ECK0474-JW0469","ushA",99,500373,502002,1629,"50M","False","f"
"913","ECK0475-JW0470","ybaK",99,502080,502536,456,"50M","False","r"
"915","ECK0476-JW0471","ybaP",99,502763,503534,771,"50M","False","r"
"917","ECK0477-JW0472","ybaQ",99,503677,503995,318,"50M","False","f"
"919","ECK0478-JW0473","copA",99,504352,506833,2481,"50M","False","r"
"921","ECK0479-JW0474","ybaS",99,507100,508009,909,"50M","False","f"
"923","ECK0480-JW0475","ybaT",99,508035,509304,1269,"50M","False","f"
"925","ECK0481-JW0476","cueR",99,509452,509836,384,"50M","False","f"
"927","ECK0482-JW5065","ybbJ",99,509878,510313,435,"50M","False","r"
"929","ECK0483-JW0478","ybbK",99,510333,511227,894,"50M","False","r"
"931","ECK0484-JW0479","ybbL",99,511378,512032,654,"50M","False","f"
"933","ECK0485-JW5066","ybbM",99,512015,512798,783,"50M","False","f"
"935","ECK0486-JW5067","ybbN",99,512902,513769,867,"50M","False","r"
"937","ECK0487-JW0482","ybbO",99,513817,514603,786,"50M","False","r"
"939","ECK0488-JW0483","tesA",99,514616,515219,603,"50M","False","r"
"941","ECK0489-JW0484","ybbA",99,515192,515855,663,"50M","False","f"
"943","ECK0490-JW0485","ybbP",99,515875,518266,2391,"50M","False","f"
"945","ECK0491-JW0486","rhsD",97,518720,522977,4257,"50M","False","f"
"947","ECK0492-JW0487","ybbC",99,523040,523385,345,"50M","False","f"
"949","ECK0493-JW0488","ylbH",99,523408,524095,687,"50M","False","f"
"951","ECK0494-JW0489","ybbD",99,524099,524336,237,"50M","False","f"
"953","none-JW5068","none",99,524892,525084,192,"50M","False","r"
"955","none-JW5069","none",99,525122,525470,348,"50M","False","r"
"957","ECK0496-JW0491","ybbB",99,525609,526680,1071,"50M","False","r"
"959","ECK0497-JW0492","ybbS",99,526772,527675,903,"50M","False","r"
"961","ECK0498-JW0493","allA",99,527910,528369,459,"50M","False","f"
"963","ECK0499-JW0494","allR",99,528470,529262,792,"50M","False","f"
"965","ECK0500-JW0495","gcl",99,529375,531133,1758,"50M","False","f"
"967","ECK0501-JW0496","hyi",99,531169,531922,753,"50M","False","f"
"969","ECK0502-JW0497","glxR",99,532045,532900,855,"50M","False","f"
"971","ECK0503-JW0498","ybbV",99,532955,533210,255,"50M","False","f"
"973","ECK0504-JW0499","ybbW",99,533092,534523,1431,"50M","False","f"
"975","ECK0505-JW0500","allB",99,534606,535944,1338,"50M","False","f"
"977","ECK0506-JW0501","ybbY",99,536024,537302,1278,"50M","False","f"
"979","ECK0507-JW0502","glxK",99,537347,538469,1122,"50M","False","f"
"981","ECK0508-JW0503","ylbA",99,538738,539500,762,"50M","False","r"
"983","ECK0509-JW0504","allC",99,539534,540746,1212,"50M","False","r"
"985","ECK0510-JW0505","allD",99,540791,541817,1026,"50M","False","r"
"987","ECK0511-JW0506","fdrA",99,542139,543783,1644,"50M","False","f"
"989","ECK0512-JW0507","ylbE",99,543816,544053,237,"50M","False","f"
"991","ECK0512-JW0508","ylbE",99,544073,545052,979,"41M1D9M","False","f"
"993","ECK0513-JW0509","ylbF",99,545086,545878,792,"50M","False","f"
"995","ECK0514-JW0510","ybcF",99,545898,546768,870,"50M","False","f"
"997","ECK0515-JW0511","purK",99,547004,548048,1044,"50M","False","r"
"999","ECK0516-JW0512","purE",99,548068,548554,486,"50M","False","r"
"1001","ECK0517-JW0513","lpxH",99,548695,549394,699,"50M","False","r"
"1003","ECK0518-JW0514","ppiB",99,549420,549891,471,"50M","False","r"
"1005","ECK0519-JW0515","cysS",99,550070,551432,1362,"50M","False","f"
"1007","ECK0520-JW0516","ybcI",99,551509,552007,498,"50M","False","r"
"1009","ECK0521-JW5070","ybcJ",99,552138,552327,189,"50M","False","r"
"1011","ECK0522-JW0518","folD",99,552352,553195,843,"50M","False","r"
"1013","ECK0523-JW0519","sfmA",99,553671,554190,519,"50M","False","f"
"1015","ECK0524-JW0520","sfmC",99,554433,555102,669,"50M","False","f"
"1017","ECK0525-JW0521","sfmD",99,555156,557736,2580,"50M","False","f"
"1019","ECK0526-JW5071","sfmH",99,557801,558755,954,"50M","False","f"
"1021","ECK0527-JW5072","sfmF",99,558789,559281,492,"50M","False","f"
"1023","ECK0528-JW5073","fimZ",99,559325,559997,672,"50M","False","r"
"1025","ECK0530-JW0525","intD",99,560292,561432,1140,"50M","False","r"
"1027","ECK0531-JW0526","ybcC",99,561575,561815,240,"50M","False","r"
"1029","ECK0532-JW0527","ybcD",99,561910,562123,213,"50M","False","f"
"1031","ECK0533-JW0530","renD",99,563521,563683,162,"50M","False","f"
"1033","ECK0534-JW0531","emrE",99,563774,564083,309,"50M","False","f"
"1035","none-JW5075","none",99,564154,564280,126,"50M","False","f"
"1037","ECK0535-JW0532","ybcK",99,564361,565864,1503,"50M","False","f"
"1039","ECK0536-JW0533","ybcL",99,566352,566880,528,"50M","False","f"
"1041","ECK0537-JW0534","ybcM",99,566913,567687,774,"50M","False","f"
"1043","ECK0538-JW0535","ybcN",99,567925,568357,432,"50M","False","f"
"1045","ECK0539-JW0536","ninE",99,568380,568527,147,"50M","False","f"
"1047","ECK0540-JW0537","ybcO",99,568543,568810,267,"50M","False","f"
"1049","ECK0541-JW0538","rusA",99,568830,569169,339,"50M","False","f"
"1051","ECK0542-JW5076","ylcG",99,569189,569306,117,"50M","False","f"
"1053","ECK0543-JW0539","ybcQ",99,569415,569775,360,"50M","False","f"
"1055","ECK0544-JW5078","nmpC",99,571235,572339,1104,"50M","False","r"
"1057","ECK0545-JW0543","essD",99,572857,573049,192,"50M","False","f"
"1059","ECK0546-JW0544","ybcS",99,573072,573546,474,"50M","False","f"
"1061","ECK0547-JW5079","rzpD",99,573554,574004,450,"50M","False","f"
"1063","ECK0548-JW5080","rzoD",99,573786,573945,159,"50M","False","f"
"1065","ECK0549-JW0546","borD",99,574077,574347,270,"50M","False","r"
"1067","ECK0550-JW5081","ybcV",99,574661,575171,510,"50M","False","r"
"1069","ECK0551-JW0548","ybcW",99,575339,575522,183,"50M","False","f"
"1071","ECK0552-JW0549","nohB",99,576293,576815,522,"50M","False","f"
"1073","ECK0553-JW5815","tfaD",99,576813,577533,720,"50M","False","f"
"1075","ECK0554-JW0551","ybcY",99,577629,578190,561,"50M","False","r"
"1077","ECK0555-JW0552","ylcE",99,578334,578496,162,"50M","False","f"
"1079","ECK0556-JW0553","appY",99,579140,579866,726,"50M","False","f"
"1081","ECK0557-JW0554","ompT",99,580157,581087,930,"50M","False","r"
"1083","ECK0558-JW0555","envY",99,581624,582362,738,"50M","False","r"
"1085","ECK0559-JW0556","ybcH",99,582568,583435,867,"50M","False","r"
"1087","ECK0560-JW0557","nfrA",99,583459,586408,2949,"50M","False","r"
"1089","ECK0561-JW0558","nfrB",99,586418,588632,2214,"50M","False","r"
"1091","ECK0562-JW5082","cusS",99,588805,590236,1431,"50M","False","r"
"1093","ECK0563-JW0560","cusR",99,590237,590897,660,"50M","False","r"
"1095","ECK0564-JW0561","cusC",99,591059,592409,1350,"50M","False","f"
"1097","ECK0565-JW0562","cusF",99,592590,592899,309,"50M","False","f"
"1099","ECK0566-JW0563","cusB",99,592938,594138,1200,"50M","False","f"
"1101","ECK0567-JW0564","cusA",99,594173,597293,3120,"50M","False","f"
"1103","ECK0568-JW0565","pheP",99,597418,598771,1353,"50M","False","f"
"1105","ECK0569-JW0566","ybdG",99,598893,600117,1224,"50M","False","r"
"1107","ECK0570-JW0567","nfnB",99,600248,600878,630,"50M","False","r"
"1109","ECK0571-JW5083","ybdF",99,600995,601451,456,"50M","False","r"
"1111","ECK0572-JW0569","ybdJ",99,601428,601653,225,"50M","False","r"
"1113","ECK0573-JW0570","ybdK",99,601742,602837,1095,"50M","False","r"
"1115","ECK0574-JW5084","hokE",99,603196,603424,228,"50M","False","f"
"1117","ECK0575-JW5085","entD",99,604936,605542,606,"50M","False","r"
"1119","ECK0576-JW5086","fepA",99,605731,608008,2277,"50M","False","r"
"1121","ECK0577-JW0576","fes",99,608274,609375,1101,"50M","False","f"
"1123","ECK0578-JW0577","ybdZ",99,609401,609596,195,"50M","False","f"
"1125","ECK0579-JW0578","entF",97,609616,613474,3858,"50M","False","f"
"1127","ECK0580-JW0579","fepE",99,613713,614823,1110,"50M","False","f"
"1129","ECK0581-JW0580","fepC",99,614861,615653,792,"50M","False","r"
"1131","ECK0582-JW0581","fepG",99,615673,616642,969,"50M","False","r"
"1133","ECK0583-JW0582","fepD",99,616662,617643,981,"50M","False","r"
"1135","ECK0584-JW0583","ybdA",99,617759,618986,1227,"50M","False","f"
"1137","ECK0585-JW0584","fepB",99,619031,619964,933,"50M","False","r"
"1139","ECK0586-JW0585","entC",99,620344,621496,1152,"50M","False","f"
"1141","ECK0587-JW0586","entE",99,621529,623116,1587,"50M","False","f"
"1143","ECK0588-JW0587","entB",99,623153,623987,834,"50M","False","f"
"1145","ECK0589-JW0588","entA",99,624010,624733,723,"50M","False","f"
"1147","ECK0590-JW0589","ybdB",99,624759,625149,390,"50M","False","f"
"1149","ECK0591-JW0590","cstA",99,625353,627435,2082,"50M","False","f"
"1151","ECK0592-JW0591","ybdD",99,627641,627815,174,"50M","False","f"
"1153","ECK0593-JW0592","ybdH",99,627866,628931,1065,"50M","False","r"
"1155","ECK0594-JW0593","ybdL",99,629045,630182,1137,"50M","False","f"
"1157","ECK0595-JW0594","ybdM",99,630224,630830,606,"50M","False","r"
"1159","ECK0596-JW0595","ybdN",99,630826,632023,1197,"50M","False","r"
"1161","ECK0597-JW0596","ybdO",99,632193,633072,879,"50M","False","r"
"1163","ECK0598-JW0597","dsbG",99,633304,634027,723,"50M","False","r"
"1165","ECK0599-JW0598","ahpC",99,634404,634944,540,"50M","False","f"
"1167","ECK0600-JW0599","ahpF",99,635212,636754,1542,"50M","False","f"
"1169","ECK0601-JW0600","uspG",99,636916,637321,405,"50M","False","r"
"1171","ECK0602-JW0601","ybdR",99,637547,638762,1215,"50M","False","f"
"1173","ECK0603-JW0602","rnk",99,639034,639421,387,"50M","False","r"
"1175","ECK0604-JW0603","rna",99,639674,640457,783,"50M","False","r"
"1177","ECK0605-JW0604","citT",99,640594,642034,1440,"50M","False","r"
"1179","ECK0606-JW0605","citG",99,642108,642963,855,"50M","False","r"
"1181","ECK0607-JW0606","citX",99,642961,643489,528,"50M","False","r"
"1183","ECK0608-JW5087","citF",99,643516,645025,1509,"50M","False","r"
"1185","ECK0609-JW0608","citE",99,645059,645944,885,"50M","False","r"
"1187","ECK0610-JW0609","citD",99,645964,646237,273,"50M","False","r"
"1189","ECK0611-JW0610","citC",99,646275,647310,1035,"50M","False","r"
"1191","ECK0612-JW0611","citA",99,647694,649329,1635,"50M","False","f"
"1193","ECK0613-JW0612","citB",99,649321,649978,657,"50M","False","f"
"1199","ECK0615-JW0617","crcA",99,652016,652553,537,"50M","False","f"
"1201","ECK0616-JW0618","cspE",99,652751,652937,186,"50M","False","f"
"1203","ECK0617-JW0619","crcB",99,653032,653392,360,"50M","False","r"
"1205","ECK0618-JW0620","ybeH",99,653490,653694,204,"50M","False","f"
"1207","ECK0619-JW0621","ybeM",99,653714,654254,540,"50M","False","f"
"1209","ECK0620-JW0622","tatE",99,654406,654586,180,"50M","False","f"
"1211","ECK0621-JW0623","lipA",99,654728,655670,942,"50M","False","r"
"1213","ECK0622-JW0624","ybeF",99,655902,656832,930,"50M","False","r"
"1215","ECK0623-JW5089","lipB",99,657114,657732,618,"50M","False","r"
"1217","ECK0624-JW0626","ybeD",99,657856,658096,240,"50M","False","r"
"1219","ECK0625-JW0627","dacA",99,658229,659417,1188,"50M","False","r"
"1221","ECK0626-JW0628","rlpA",99,659579,660644,1065,"50M","False","r"
"1223","ECK0627-JW0629","mrdB",99,660678,661767,1089,"50M","False","r"
"1225","ECK0628-JW0630","mrdA",99,661793,663671,1878,"50M","False","r"
"1227","ECK0629-JW0631","ybeA",99,663725,664169,444,"50M","False","r"
"1229","ECK0630-JW5090","ybeB",99,664196,664382,186,"50M","False","r"
"1231","ECK0631-JW0633","cobC",99,664773,665361,588,"50M","False","r"
"1233","ECK0632-JW0634","nadD",99,665408,666026,618,"50M","False","r"
"1235","ECK0633-JW0635","holA",99,666051,667059,1008,"50M","False","r"
"1237","ECK0634-JW0636","rlpB",99,667082,667640,558,"50M","False","r"
"1239","ECK0635-JW0637","leuS",99,667678,670237,2559,"50M","False","r"
"1241","ECK0636-JW0638","ybeL",99,670477,670936,459,"50M","False","f"
"1243","ECK0637-JW5091","ybeQ",99,671047,672007,960,"50M","False","r"
"1245","ECK0638-JW0640","ybeR",99,672170,672854,684,"50M","False","f"
"1247","ECK0639-JW0641","djlB",99,672874,674278,1404,"50M","False","f"
"1249","ECK0640-JW0642","ybeT",99,674329,674860,531,"50M","False","r"
"1251","ECK0641-JW0643","ybeU",99,674967,675651,684,"50M","False","f"
"1253","ECK0642-JW0644","djlC",99,675671,677099,1428,"50M","False","f"
"1255","ECK0643-JW0645","hscC",99,677200,678847,1647,"50M","False","r"
"1257","ECK0644-JW0646","rihA",99,678954,679866,912,"50M","False","r"
"1259","ECK0645-JW0647","gltL",99,680007,680709,702,"50M","False","r"
"1261","ECK0646-JW0648","gltK",99,680732,681383,651,"50M","False","r"
"1263","ECK0647-JW0649","gltJ",99,681406,682123,717,"50M","False","r"
"1265","ECK0648-JW5092","gltI",99,682316,683201,885,"50M","False","r"
"1267","ECK0649-JW0654","lnt",99,684820,686335,1515,"50M","False","r"
"1269","ECK0650-JW0655","ybeX",99,686383,687238,855,"50M","False","r"
"1271","ECK0651-JW0656","ybeY",99,687351,687795,444,"50M","False","r"
"1273","ECK0652-JW0657","ybeZ",99,687815,688871,1056,"50M","False","r"
"1275","ECK0653-JW0658","miaB",99,689008,690409,1401,"50M","False","r"
"1277","ECK0654-JW0659","ubiF",99,690560,691712,1152,"50M","False","f"
"1279","ECK0662-JW0660","asnB",99,692990,694631,1641,"50M","False","r"
"1281","ECK0663-JW0661","nagD",99,695051,695780,729,"50M","False","r"
"1283","ECK0664-JW0662","nagC",99,695851,697048,1197,"50M","False","r"
"1285","ECK0665-JW0663","nagA",99,697080,698205,1125,"50M","False","r"
"1287","ECK0666-JW0664","nagB",99,698288,699065,777,"50M","False","r"
"1289","ECK0667-JW0665","nagE",99,699403,701326,1923,"50M","False","f"
"1291","ECK0668-JW0666","glnS",99,701552,703193,1641,"50M","False","f"
"1293","ECK0669-JW0667","ybfM",99,703793,705176,1383,"50M","False","f"
"1295","ECK0670-JW0668","ybfN",99,705249,705552,303,"50M","False","f"
"1297","ECK0671-JW0669","fur",99,705677,706100,423,"50M","False","r"
"1299","none-JW0670","none",99,706150,706381,231,"50M","False","f"
"1301","ECK0672-JW0671","fldA",99,706412,706919,507,"50M","False","r"
"1303","ECK0673-JW5816","ybfE",99,707082,707421,339,"50M","False","r"
"1305","ECK0674-JW0673","ybfF",99,707515,708256,741,"50M","False","r"
"1307","ECK0675-JW0674","seqA",99,708446,708968,522,"50M","False","f"
"1309","ECK0676-JW0675","pgm",99,709017,710634,1617,"50M","False","f"
"1311","ECK0677-JW0676","ybfP",99,710871,711342,471,"50M","False","f"
"1313","ECK0678-JW5094","ybfG",99,711424,711763,339,"50M","False","r"
"1315","ECK0679-JW5095","ybfH",99,711865,712159,294,"50M","False","r"
"1317","ECK0680-JW0679","potE",99,712423,713719,1296,"50M","False","r"
"1319","ECK0681-JW0680","speF",99,713739,715914,2175,"50M","False","r"
"1321","none-JW0681","none",99,716042,716276,234,"50M","False","f"
"1323","ECK0682-JW5096","kdpE",99,716533,717112,579,"50M","False","r"
"1325","ECK0683-JW0683","kdpD",99,717207,719868,2661,"50M","False","r"
"1327","ECK0684-JW0684","kdpC",99,719884,720433,549,"50M","False","r"
"1329","ECK0685-JW0685","kdpB",99,720465,722490,2025,"50M","False","r"
"1331","ECK0686-JW0686","kdpA",99,722536,724186,1650,"50M","False","r"
"1333","ECK0687-JW0687","kdpF",99,724209,724275,66,"50M","False","r"
"1335","ECK0688-JW0688","ybfA",99,724593,724776,183,"50M","False","f"
"1337","ECK0689-JW0689","rhsC",97,725042,729212,4170,"50M","False","f"
"1339","ECK0690-JW0691","ybfB",99,729235,729538,303,"50M","False","f"
"1341","ECK0691-JW0692","ybfO",99,729679,731089,1410,"50M","False","f"
"1343","ECK0692-JW0693","ybfC",99,731109,731655,546,"50M","False","f"
"1345","ECK0693-JW0694","ybfQ",99,731904,732135,231,"50M","False","f"
"1347","ECK0694-JW0695","ybfL",99,732359,733397,1038,"50M","False","f"
"1349","ECK0695-JW0696","ybfD",99,733551,734289,738,"50M","False","f"
"1351","ECK0696-JW0697","ybgA",99,734460,734946,486,"50M","False","f"
"1353","ECK0697-JW0698","phr",99,734966,736361,1395,"50M","False","f"
"1355","ECK0698-JW0699","ybgH",99,736552,738010,1458,"50M","False","r"
"1357","ECK0699-JW0700","ybgI",99,738286,739006,720,"50M","False","f"
"1359","ECK0700-JW0701","ybgJ",99,739052,739685,633,"50M","False","f"
"1361","ECK0701-JW0702","ybgK",99,739702,740611,909,"50M","False","f"
"1363","ECK0702-JW0703","ybgL",99,740624,741335,711,"50M","False","f"
"1365","ECK0703-JW0704","nei",99,741394,742162,768,"50M","False","f"
"1367","ECK0704-JW5097","abrB",99,742200,743268,1068,"50M","False","r"
"1369","ECK0705-JW5098","ybgO",99,743398,744463,1065,"50M","False","r"
"1371","ECK0706-JW0707","ybgP",99,744456,745161,705,"50M","False","r"
"1373","ECK0707-JW5099","ybgQ",99,745199,747674,2475,"50M","False","r"
"1375","ECK0708-JW0709","ybgD",99,747706,748249,543,"50M","False","r"
"1377","ECK0709-JW0710","gltA",99,748662,749922,1260,"50M","False","r"
"1379","ECK0710-JW0711","sdhC",99,750636,751002,366,"50M","False","f"
"1381","ECK0711-JW0712","sdhD",99,751019,751343,324,"50M","False","f"
"1383","ECK0712-JW0713","sdhA",99,751366,753109,1743,"50M","False","f"
"1385","ECK0713-JW0714","sdhB",99,753148,753841,693,"50M","False","f"
"1387","ECK0714-JW0715","sucA",99,754165,756943,2778,"50M","False","f"
"1389","ECK0715-JW0716","sucB",99,756981,758175,1194,"50M","False","f"
"1391","ECK0716-JW0717","sucC",99,758473,759616,1143,"50M","False","f"
"1393","ECK0717-JW0718","sucD",99,759639,760485,846,"50M","False","f"
"1395","ECK0718-JW0719","mngR",99,760630,761329,699,"50M","False","r"
"1397","ECK0719-JW0720","mngA",99,761443,763396,1953,"50M","False","f"
"1399","ECK0720-JW0721","mngB",99,763437,766047,2610,"50M","False","f"
"1401","ECK0721-JW0722","cydA",99,766917,768462,1545,"50M","False","f"
"1403","ECK0722-JW0723","cydB",99,768501,769617,1116,"50M","False","f"
"1405","ECK0723-JW0724","ybgT",99,769655,769745,90,"50M","False","f"
"1407","ECK0724-JW0725","ybgE",99,769768,770038,270,"50M","False","f"
"1409","ECK0725-JW0726","ybgC",99,770211,770592,381,"50M","False","f"
"1411","ECK0726-JW0727","tolQ",99,770612,771281,669,"50M","False","f"
"1413","ECK0727-JW0728","tolR",99,771308,771713,405,"50M","False","f"
"1415","ECK0728-JW0729","tolA",99,771801,773043,1242,"50M","False","f"
"1417","ECK0729-JW5100","tolB",99,773199,774468,1269,"50M","False","f"
"1419","ECK0730-JW0731","pal",99,774526,775024,498,"50M","False","f"
"1421","ECK0731-JW0732","ybgF",99,775057,775825,768,"50M","False","f"
"1423","ECK0739-JW0733","nadA",99,777544,778564,1020,"50M","False","f"
"1425","ECK0740-JW0734","pnuC",99,778625,779321,696,"50M","False","f"
"1427","none-JW0735","none",99,779359,780277,918,"50M","False","f"
"1429","ECK0741-JW5101","zitB",99,779359,779626,267,"50M","False","r"
"1431","ECK0742-JW0736","ybgS",99,780414,780771,357,"50M","False","r"
"1433","ECK0743-JW0737","aroG",99,781092,782121,1029,"50M","False","f"
"1435","ECK0744-JW0738","gpmA",99,782320,783049,729,"50M","False","r"
"1437","ECK0745-JW0739","galM",99,783274,784291,1017,"50M","False","r"
"1439","ECK0746-JW0740","galK",99,784308,785433,1125,"50M","False","r"
"1441","ECK0747-JW0741","galT",99,785460,786483,1023,"50M","False","r"
"1443","ECK0748-JW0742","galE",99,786516,787509,993,"50M","False","r"
"1445","ECK0749-JW0743","modF",99,787793,789242,1449,"50M","False","r"
"1447","ECK0750-JW0744","modE",99,789333,790098,765,"50M","False","r"
"1449","ECK0751-JW5102","ybhT",99,790226,790358,132,"50M","False","f"
"1451","ECK0752-JW0746","modA",99,790548,791298,750,"50M","False","f"
"1453","ECK0753-JW0747","modB",99,791321,791987,666,"50M","False","f"
"1455","ECK0754-JW0748","modC",99,792013,793048,1035,"50M","False","f"
"1457","ECK0755-JW0749","ybhA",99,793090,793885,795,"50M","False","r"
"1459","ECK0756-JW0750","ybhE",99,794045,795017,972,"50M","False","f"
"1461","ECK0757-JW5896","ybhD",99,795099,796092,993,"50M","False","r"
"1463","ECK0758-JW0752","ybhH",99,796218,797247,1029,"50M","False","f"
"1465","ECK0759-JW0753","ybhI",99,797346,798756,1410,"50M","False","f"
"1467","ECK0760-JW5103","ybhJ",99,798959,801200,2241,"50M","False","f"
"1469","ECK0761-JW0755","ybhC",99,801475,802735,1260,"50M","False","r"
"1471","ECK0762-JW0756","ybhB",99,802910,803363,453,"50M","False","r"
"1473","ECK0763-JW0757","bioA",99,803445,804711,1266,"50M","False","r"
"1475","ECK0764-JW0758","bioB",99,804803,805820,1017,"50M","False","f"
"1477","ECK0765-JW0759","bioF",99,805840,806971,1131,"50M","False","f"
"1479","ECK0766-JW0760","bioC",99,806981,807713,732,"50M","False","f"
"1481","ECK0767-JW0761","bioD",99,807729,808383,654,"50M","False","f"
"1483","ECK0768-JW0762","uvrB",99,808985,810983,1998,"50M","False","f"
"1485","ECK0769-JW0763","ybhK",99,811216,812101,885,"50M","False","r"
"1487","ECK0770-JW0764","moaA",99,812503,813469,966,"50M","False","f"
"1489","ECK0771-JW0765","moaB",99,813514,814003,489,"50M","False","f"
"1491","ECK0772-JW0766","moaC",99,814029,814491,462,"50M","False","f"
"1493","ECK0773-JW0767","moaD",99,814507,814729,222,"50M","False","f"
"1495","ECK0774-JW0768","moaE",99,814754,815183,429,"50M","False","f"
"1497","ECK0775-JW0769","ybhL",99,815343,816024,681,"50M","False","f"
"1499","ECK0776-JW0770","ybhM",99,816252,816942,690,"50M","False","f"
"1501","ECK0777-JW0771","ybhN",99,817019,817952,933,"50M","False","r"
"1503","ECK0778-JW0772","ybhO",99,817975,819193,1218,"50M","False","r"
"1505","ECK0779-JW0773","ybhP",99,819213,819951,738,"50M","False","r"
"1507","ECK0780-JW0774","ybhQ",99,820089,820476,387,"50M","False","f"
"1509","ECK0781-JW5803","ybhR",99,820479,821268,789,"50M","False","r"
"1511","ECK0782-JW0777","ybhS",99,821596,822706,1110,"50M","False","r"
"1513","ECK0783-JW5104","ybhF",99,822722,824435,1713,"50M","False","r"
"1515","ECK0784-JW0779","ybhG",99,824451,825426,975,"50M","False","r"
"1517","ECK0785-JW0780","ybiH",99,825449,826097,648,"50M","False","r"
"1519","ECK0786-JW0781","rhlE",99,826331,827672,1341,"50M","False","f"
"1521","ECK0787-JW0783","ybiA",99,827945,828404,459,"50M","False","r"
"1523","ECK0788-JW0784","dinG",99,828529,830656,2127,"50M","False","f"
"1525","ECK0789-JW0785","ybiB",99,830707,831646,939,"50M","False","f"
"1527","ECK0790-JW0786","ybiC",99,831810,832872,1062,"50M","False","f"
"1529","ECK0791-JW0787","ybiJ",99,833142,833379,237,"50M","False","r"
"1531","ECK0792-JW0788","ybiI",99,833667,833910,243,"50M","False","r"
"1533","ECK0793-JW5105","ybiX",99,834007,834697,690,"50M","False","r"
"1535","ECK0794-JW0790","fiu",99,834726,836985,2259,"50M","False","r"
"1537","ECK0795-JW5106","ybiM",99,837273,837510,237,"50M","False","r"
"1539","ECK0796-JW5107","ybiN",99,837710,838694,984,"50M","False","f"
"1541","ECK0797-JW5108","ybiO",99,838732,841069,2337,"50M","False","r"
"1543","ECK0798-JW0794","glnQ",99,841218,841917,699,"50M","False","r"
"1545","ECK0799-JW0795","glnP",99,841937,842573,636,"50M","False","r"
"1547","ECK0800-JW0796","glnH",99,842735,843458,723,"50M","False","r"
"1549","ECK0801-JW0797","dps",99,843885,844365,480,"50M","False","r"
"1551","ECK0802-JW0798","rhtA",99,844687,845551,864,"50M","False","r"
"1553","ECK0803-JW0799","ompX",99,845909,846401,492,"50M","False","f"
"1555","ECK0804-JW0800","ybiP",99,846491,848051,1560,"50M","False","r"
"1557","ECK0807-JW0801","mntR",99,848642,849086,444,"50M","False","f"
"1559","ECK0808-JW0802","ybiR",99,849106,850201,1095,"50M","False","f"
"1561","ECK0809-JW0803","ybiS",99,850301,851198,897,"50M","False","r"
"1563","ECK0810-JW0804","ybiT",99,851422,852991,1569,"50M","False","f"
"1565","ECK0811-JW0805","ybiU",99,853273,854515,1242,"50M","False","r"
"1567","ECK0812-JW0806","ybiV",99,854690,855482,792,"50M","False","r"
"1569","ECK0813-JW0807","ybiW",99,855651,858060,2409,"50M","False","r"
"1571","ECK0814-JW0808","ybiY",99,858089,858992,903,"50M","False","r"
"1573","ECK0815-JW5109","fsaA",99,859029,859740,711,"50M","False","f"
"1575","ECK0816-JW0810","moeB",99,859857,860583,726,"50M","False","r"
"1577","ECK0817-JW0811","moeA",99,860606,861818,1212,"50M","False","r"
"1579","ECK0818-JW0812","iaaA",99,862027,862969,942,"50M","False","f"
"1581","ECK0819-JW5897","yliA",99,862961,864827,1866,"50M","False","f"
"1583","ECK0820-JW5111","yliB",99,864870,866385,1515,"50M","False","f"
"1585","ECK0821-JW0815","yliC",99,866426,867323,897,"50M","False","f"
"1587","ECK0822-JW0816","yliD",99,867349,868237,888,"50M","False","f"
"1589","ECK0823-JW0817","yliE",99,868438,870763,2325,"50M","False","f"
"1591","ECK0824-JW0818","yliF",99,870794,872099,1305,"50M","False","f"
"1593","ECK0825-JW0819","yliG",99,872187,873489,1302,"50M","False","r"
"1595","ECK0826-JW0820","yliH",99,873707,874067,360,"50M","False","f"
"1597","ECK0827-JW0821","yliI",99,874201,875293,1092,"50M","False","f"
"1599","ECK0828-JW0822","yliJ",99,875331,875934,603,"50M","False","r"
"1601","ECK0829-JW0823","dacC",99,876186,877365,1179,"50M","False","f"
"1603","ECK0830-JW0824","deoR",99,877453,878188,735,"50M","False","r"
"1605","ECK0831-JW5112","ybjG",99,878269,878857,588,"50M","False","r"
"1607","ECK0832-JW0826","cmr",99,879132,880341,1209,"50M","False","f"
"1609","ECK0833-JW0827","ybjH",99,880423,880684,261,"50M","False","r"
"1611","ECK0834-JW5113","ybjI",99,880793,881588,795,"50M","False","r"
"1613","ECK0835-JW0829","ybjJ",99,881608,882793,1185,"50M","False","r"
"1615","ECK0836-JW5114","ybjK",99,882852,883395,543,"50M","False","f"
"1617","none-JW5115","none",99,883476,883578,102,"50M","False","f"
"1619","ECK0838-JW0831","ybjL",99,883611,885273,1662,"50M","False","r"
"1621","ECK0839-JW0832","ybjM",99,885548,885902,354,"50M","False","f"
"1623","ECK0840-JW0833","grxA",99,885973,886207,234,"50M","False","r"
"1625","ECK0841-JW0834","ybjC",99,886372,886636,264,"50M","False","f"
"1627","ECK0842-JW0835","nfsA",99,886643,887342,699,"50M","False","f"
"1629","ECK0843-JW0836","rimK",99,887426,888305,879,"50M","False","f"
"1631","ECK0844-JW0837","ybjN",99,888416,888869,453,"50M","False","f"
"1633","ECK0845-JW0838","potF",99,889243,890332,1089,"50M","False","f"
"1635","ECK0846-JW5818","potG",99,890369,891560,1191,"50M","False","f"
"1637","ECK0847-JW0840","potH",99,891593,892523,930,"50M","False","f"
"1639","ECK0848-JW0841","potI",99,892543,893365,822,"50M","False","f"
"1641","ECK0849-JW0842","ybjO",99,893448,893913,465,"50M","False","f"
"1643","ECK0850-JW0843","rumB",99,893977,895081,1104,"50M","False","f"
"1645","ECK0851-JW0844","artJ",99,895321,896029,708,"50M","False","r"
"1647","ECK0852-JW0845","artM",99,896343,896988,645,"50M","False","r"
"1649","ECK0853-JW0846","artQ",99,897011,897704,693,"50M","False","r"
"1651","ECK0854-JW0847","artI",99,897734,898442,708,"50M","False","r"
"1653","ECK0855-JW0848","artP",99,898483,899188,705,"50M","False","r"
"1655","ECK0856-JW0849","ybjP",99,899429,899921,492,"50M","False","r"
"1657","ECK0857-JW0850","ybjQ",99,900052,900352,300,"50M","False","f"
"1659","ECK0858-JW0851","ybjR",99,900372,901179,807,"50M","False","f"
"1661","ECK0859-JW5819","ybjS",99,901217,902243,1026,"50M","False","r"
"1663","ECK0860-JW5116","ybjT",99,902329,903811,1482,"50M","False","r"
"1665","ECK0861-JW0854","ltaE",99,903770,904748,978,"50M","False","r"
"1667","ECK0862-JW0855","poxB",99,904808,906503,1695,"50M","False","r"
"1669","ECK0863-JW5117","hcr",99,906659,907604,945,"50M","False","r"
"1671","ECK0864-JW0857","hcp",99,907639,909268,1629,"50M","False","r"
"1673","ECK0865-JW0858","ybjE",99,909435,910311,876,"50M","False","r"
"1675","ECK0866-JW0859","aqpZ",99,910829,911501,672,"50M","False","r"
"1677","ECK0867-JW0860","ybjD",99,911932,913567,1635,"50M","False","f"
"1679","ECK0868-JW0861","ybjX",99,913605,914574,969,"50M","False","r"
"1681","ECK0869-JW0862","macA",99,914694,915786,1092,"50M","False","f"
"1683","ECK0870-JW0863","macB",99,915806,917729,1923,"50M","False","f"
"1685","ECK0871-JW0864","cspD",99,917843,918044,201,"50M","False","r"
"1687","ECK0872-JW0865","clpS",99,918372,918669,297,"50M","False","f"
"1689","ECK0873-JW0866","clpA",99,918723,920976,2253,"50M","False","f"
"1691","ECK0875-JW0867","infA",99,921702,921897,195,"50M","False","r"
"1693","ECK0876-JW0868","aat",99,922205,922886,681,"50M","False","r"
"1695","ECK0877-JW0869","cydC",99,922951,924649,1698,"50M","False","r"
"1697","ECK0878-JW0870","cydD",99,924673,926416,1743,"50M","False","r"
"1699","ECK0879-JW0871","trxB",99,926562,927504,942,"50M","False","r"
"1701","ECK0880-JW0872","lrp",99,928054,928525,471,"50M","False","f"
"1703","ECK0881-JW0873","ftsK",97,928683,932649,3966,"50M","False","f"
"1705","ECK0882-JW0874","lolA",99,932828,933419,591,"50M","False","f"
"1707","ECK0883-JW0875","ycaJ",99,933453,934773,1320,"50M","False","f"
"1709","ECK0884-JW0876","serS",99,934887,936156,1269,"50M","False","f"
"1711","ECK0885-JW5118","dmsA",99,936418,938839,2421,"50M","False","f"
"1713","ECK0886-JW0878","dmsB",99,938873,939467,594,"50M","False","f"
"1715","ECK0887-JW0879","dmsC",99,939492,940332,840,"50M","False","f"
"1717","ECK0888-JW0880","ycaC",99,940408,941011,603,"50M","False","r"
"1719","ECK0889-JW0881","ycaD",99,941330,942455,1125,"50M","False","f"
"1721","ECK0890-JW5119","ycaM",99,942496,944095,1599,"50M","False","f"
"1723","ECK0891-JW0883","ycaN",99,944137,945022,885,"50M","False","r"
"1725","ECK0892-JW0884","ycaK",99,945127,945694,567,"50M","False","f"
"1727","ECK0893-JW0885","pflA",99,945817,946534,717,"50M","False","r"
"1729","ECK0894-JW0886","pflB",99,946749,949008,2259,"50M","False","r"
"1731","ECK0895-JW0887","focA",99,949086,949920,834,"50M","False","r"
"1733","ECK0896-JW0888","ycaO",99,950349,952086,1737,"50M","False","r"
"1735","ECK0897-JW0889","ycaP",99,952221,952890,669,"50M","False","f"
"1737","ECK0898-JW0890","serC",99,953112,954177,1065,"50M","False","f"
"1739","ECK0899-JW0891","aroA",99,954271,955531,1260,"50M","False","f"
"1741","ECK0900-JW0892","ycaL",99,955723,956464,741,"50M","False","f"
"1743","ECK0901-JW0893","cmk",99,956660,957320,660,"50M","False","f"
"1745","ECK0902-JW0894","rpsA",99,957454,959104,1650,"50M","False","f"
"1747","ECK0903-JW0895","ihfB",99,959287,959548,261,"50M","False","f"
"1749","ECK0904-JW5120","ycaI",99,959701,962020,2319,"50M","False","f"
"1751","ECK0905-JW0897","msbA",99,962080,963805,1725,"50M","False","f"
"1753","ECK0906-JW0898","lpxK",99,963825,964788,963,"50M","False","f"
"1755","ECK0907-JW0899","ycaQ",99,964848,966057,1209,"50M","False","f"
"1757","ECK0908-JW0900","ycaR",99,966132,966291,159,"50M","False","f"
"1759","ECK0909-JW0901","kdsB",99,966311,967034,723,"50M","False","f"
"1761","ECK0910-JW0902","ycbJ",99,967211,968081,870,"50M","False","f"
"1763","ECK0911-JW0903","ycbC",99,968099,968855,756,"50M","False","r"
"1765","ECK0912-JW0904","smtA",99,968996,969758,762,"50M","False","f"
"1767","ECK0913-JW0905","mukF",99,969778,971077,1299,"50M","False","f"
"1769","ECK0914-JW0906","mukE",99,971108,971762,654,"50M","False","f"
"1771","ECK0915-JW0907","mukB",97,971785,976222,4437,"50M","False","f"
"1773","ECK0916-JW0908","ycbB",99,976506,978330,1824,"50M","False","f"
"1775","ECK0917-JW0909","ycbK",99,978534,979059,525,"50M","False","f"
"1777","ECK0918-JW0910","ycbL",99,979109,979733,624,"50M","False","f"
"1779","ECK0919-JW0911","aspC",99,979996,981163,1167,"50M","False","r"
"1781","ECK0920-JW0912","ompF",99,981371,982436,1065,"50M","False","r"
"1783","ECK0921-JW0913","asnS",99,983062,984439,1377,"50M","False","r"
"1785","ECK0922-JW0914","pncB",99,984631,985810,1179,"50M","False","r"
"1787","ECK0923-JW0915","pepN",99,986081,988670,2589,"50M","False","f"
"1789","ECK0924-JW0916","ssuB",99,988754,989498,744,"50M","False","r"
"1791","ECK0925-JW5121","ssuC",99,989518,990286,768,"50M","False","r"
"1793","ECK0926-JW0918","ssuD",99,990320,991442,1122,"50M","False","r"
"1795","ECK0927-JW0919","ssuA",99,991462,992398,936,"50M","False","r"
"1797","ECK0928-JW0920","ssuE",99,992414,992966,552,"50M","False","r"
"1799","ECK0929-JW5122","ycbQ",99,993327,993843,516,"50M","False","f"
"1801","ECK0930-JW0922","ycbR",99,993949,994627,678,"50M","False","f"
"1803","ECK0931-JW0923","ycbS",99,994675,997252,2577,"50M","False","f"
"1805","ECK0932-JW0924","ycbT",99,997266,998313,1047,"50M","False","f"
"1807","ECK0933-JW0925","ycbU",99,998348,998867,519,"50M","False","f"
"1809","ECK0934-JW5123","ycbV",99,998850,999390,540,"50M","False","f"
"1811","ECK0935-JW5124","ycbF",99,999379,1000093,714,"50M","False","f"
"1813","ECK0936-JW0928","pyrD",99,1000227,1001214,987,"50M","False","f"
"1815","ECK0937-JW5125","ycbW",99,1001375,1001930,555,"50M","False","f"
"1817","ECK0938-JW5126","ycbX",99,1001968,1003012,1044,"50M","False","r"
"1819","ECK0939-JW0931","ycbY",99,1003303,1005388,2085,"50M","False","f"
"1821","ECK0940-JW0932","uup",99,1005423,1007307,1884,"50M","False","f"
"1823","ECK0941-JW0933","pqiA",99,1007460,1008690,1230,"50M","False","f"
"1825","ECK0942-JW0934","pqiB",99,1008718,1010335,1617,"50M","False","f"
"1827","ECK0943-JW5127","ymbA",99,1010355,1010895,540,"50M","False","f"
"1829","ECK0944-JW0936","rmf",99,1011174,1011318,144,"50M","False","f"
"1831","ECK0945-JW0937","fabA",99,1011429,1011924,495,"50M","False","r"
"1833","ECK0946-JW0938","ycbZ",99,1012016,1013753,1737,"50M","False","r"
"1835","ECK0947-JW0939","ycbG",99,1013944,1014373,429,"50M","False","f"
"1837","ECK0948-JW0940","ompA",99,1014490,1015507,1017,"50M","False","r"
"1839","ECK0949-JW0941","sulA",99,1015887,1016373,486,"50M","False","r"
"1841","ECK0950-JW0942","yccR",99,1016597,1017203,606,"50M","False","f"
"1843","ECK0951-JW5128","yccS",99,1017207,1019346,2139,"50M","False","r"
"1845","ECK0952-JW0944","yccF",99,1019379,1019802,423,"50M","False","r"
"1847","ECK0953-JW0945","helD",99,1019930,1021961,2031,"50M","False","f"
"1849","ECK0954-JW5129","mgsA",99,1022034,1022469,435,"50M","False","r"
"1851","ECK0955-JW0947","yccT",99,1022588,1023227,639,"50M","False","r"
"1853","ECK0956-JW5130","yccU",99,1023351,1023795,444,"50M","False","f"
"1855","ECK0957-JW5970","yccV",99,1023881,1024226,345,"50M","False","r"
"1857","ECK0958-JW5898","yccW",99,1024256,1025423,1167,"50M","False","r"
"1859","ECK0959-JW5131","yccX",99,1025310,1025778,468,"50M","False","f"
"1861","ECK0960-JW0952","yccK",99,1025816,1026122,306,"50M","False","r"
"1863","ECK0961-JW0953","yccA",99,1026236,1026872,636,"50M","False","r"
"1865","ECK0963-JW0954","hyaA",99,1027598,1028693,1095,"50M","False","f"
"1867","ECK0964-JW0955","hyaB",99,1028713,1030483,1770,"50M","False","f"
"1869","ECK0965-JW0956","hyaC",99,1030525,1031209,684,"50M","False","f"
"1871","ECK0966-JW0957","hyaD",99,1031229,1031793,564,"50M","False","f"
"1873","ECK0967-JW0958","hyaE",99,1031813,1032188,375,"50M","False","f"
"1875","ECK0968-JW0959","hyaF",99,1032208,1033042,834,"50M","False","f"
"1877","ECK0969-JW0960","appC",99,1033199,1034720,1521,"50M","False","f"
"1879","ECK0970-JW0961","appB",99,1034755,1035868,1113,"50M","False","f"
"1881","none-JW0962","none",99,1035904,1035973,69,"50M","False","f"
"1883","ECK0971-JW0963","appA",99,1036076,1037351,1275,"50M","False","f"
"1885","ECK0972-JW0964","yccC",99,1037507,1039664,2157,"50M","False","r"
"1887","ECK0973-JW5132","etp",99,1039707,1040142,435,"50M","False","r"
"1889","ECK0974-JW0966","yccZ",99,1040141,1041257,1116,"50M","False","r"
"1891","ECK0975-JW0967","ymcA",99,1041326,1043399,2073,"50M","False","r"
"1893","ECK0976-JW0968","ymcB",99,1043422,1044145,723,"50M","False","r"
"1895","ECK0977-JW0969","ymcC",99,1044165,1044786,621,"50M","False","r"
"1897","ECK0978-JW5133","ymcD",99,1044916,1045216,300,"50M","False","r"
"1899","ECK0979-JW5134","cspH",99,1046440,1046629,189,"50M","False","r"
"1901","ECK0980-JW0974","cspG",99,1046920,1047109,189,"50M","False","f"
"1903","ECK0981-JW0975","ymcE",99,1047306,1047513,207,"50M","False","f"
"1905","ECK0982-JW0976","gnsA",99,1047526,1047676,150,"50M","False","f"
"1907","ECK0983-JW0977","yccM",99,1047766,1048816,1050,"50M","False","r"
"1909","ECK0984-JW5135","torS",99,1048911,1051602,2691,"50M","False","r"
"1911","ECK0985-JW0979","torT",99,1051720,1052725,1005,"50M","False","f"
"1913","ECK0986-JW0980","torR",99,1052739,1053408,669,"50M","False","r"
"1915","ECK0987-JW0981","torC",99,1053543,1054692,1149,"50M","False","f"
"1917","ECK0988-JW0982","torA",99,1054715,1057238,2523,"50M","False","f"
"1919","ECK0989-JW0983","torD",99,1057258,1057834,576,"50M","False","f"
"1921","ECK0990-JW0984","cbpM",99,1058027,1058309,282,"50M","False","r"
"1923","ECK0991-JW0985","cbpA",99,1058332,1059229,897,"50M","False","r"
"1925","ECK0992-JW0986","yccE",99,1059495,1060728,1233,"50M","False","f"
"1927","ECK0993-JW0987","agp",99,1061044,1062262,1218,"50M","False","f"
"1929","ECK0994-JW0988","yccJ",99,1062341,1062545,204,"50M","False","r"
"1931","ECK0995-JW0989","wrbA",99,1062589,1063162,573,"50M","False","r"
"1933","ECK0996-JW5136","ymdF",99,1063510,1063690,180,"50M","False","f"
"1935","ECK0997-JW5137","ycdG",99,1063988,1065359,1371,"50M","False","r"
"1937","ECK0998-JW5138","ycdH",99,1065337,1065889,552,"50M","False","r"
"1939","ECK0999-JW0993","ycdI",99,1065842,1066409,567,"50M","False","r"
"1941","ECK1000-JW0994","rarA",99,1066442,1067219,777,"50M","False","r"
"1943","ECK1001-JW0995","ycdK",99,1067250,1067613,363,"50M","False","r"
"1945","ECK1002-JW5139","ycdL",99,1067648,1068320,672,"50M","False","r"
"1947","ECK1003-JW0997","ycdM",99,1068340,1069465,1125,"50M","False","r"
"1949","ECK1004-JW0998","ycdC",99,1069701,1070316,615,"50M","False","f"
"1951","ECK1005-JW0999","putA",97,1070397,1074336,3939,"50M","False","r"
"1953","none-JW1000","none",99,1074511,1074679,168,"50M","False","r"
"1955","ECK1006-JW1001","putP",99,1074764,1076249,1485,"50M","False","f"
"1957","none-JW5140","none",99,1076495,1076774,279,"50M","False","r"
"1959","ECK1007-JW5141","ycdN",99,1076815,1076902,87,"50M","False","f"
"1961","ECK1007-JW1002","ycdN",99,1076913,1077621,708,"50M","False","f"
"1963","ECK1008-JW1003","ycdO",99,1077702,1078806,1104,"50M","False","f"
"1965","ECK1009-JW1004","ycdB",99,1078835,1080083,1248,"50M","False","f"
"1967","ECK1010-JW1005","phoH",99,1080451,1081492,1041,"50M","False","f"
"1969","ECK1011-JW1006","ycdP",99,1081583,1081973,390,"50M","False","r"
"1971","ECK1012-JW1007","ycdQ",99,1081998,1083300,1302,"50M","False","r"
"1973","ECK1013-JW5142","ycdR",99,1083316,1083604,288,"50M","False","r"
"1975","ECK1014-JW1010","ycdS",99,1085343,1087743,2400,"50M","False","r"
"1977","ECK1015-JW5143","ycdT",99,1088335,1089670,1335,"50M","False","f"
"1979","ECK1016-JW5145","ymdE",99,1091003,1091282,279,"50M","False","f"
"1981","ECK1017-JW1015","ycdU",99,1091302,1092265,963,"50M","False","f"
"1983","ECK1019-JW5146","ycdW",99,1093345,1094260,915,"50M","False","f"
"1985","ECK1020-JW1017","ycdX",99,1094338,1095052,714,"50M","False","f"
"1987","ECK1021-JW1018","ycdY",99,1095099,1095630,531,"50M","False","f"
"1989","ECK1022-JW5147","ycdZ",99,1095707,1096223,516,"50M","False","f"
"1991","ECK1023-JW1020","csgG",99,1096328,1097138,810,"50M","False","r"
"1993","ECK1024-JW1021","csgF",99,1097188,1097581,393,"50M","False","r"
"1995","ECK1025-JW1022","csgE",99,1097629,1097995,366,"50M","False","r"
"1997","ECK1026-JW1023","csgD",99,1098023,1098650,627,"50M","False","r"
"1999","none-JW5148","none",99,1099140,1099302,162,"50M","False","r"
"2001","ECK1027-JW1024","csgB",99,1099410,1099842,432,"50M","False","f"
"2003","ECK1028-JW1025","csgA",99,1099906,1100338,432,"50M","False","f"
"2005","ECK1029-JW1026","csgC",99,1100420,1100729,309,"50M","False","f"
"2007","ECK1030-JW1031","ymdA",99,1100881,1101161,280,"8S42M","False","f"
"2009","ECK1031-JW1032","ymdB",99,1101279,1101789,510,"50M","False","f"
"2011","ECK1032-JW5150","ymdC",99,1101814,1103212,1398,"50M","False","f"
"2013","ECK1033-JW1034","mdoC",99,1103261,1104395,1134,"50M","False","r"
"2015","ECK1034-JW1035","mdoG",99,1104794,1106306,1512,"50M","False","f"
"2017","ECK1035-JW1037","mdoH",99,1106322,1108842,2520,"50M","False","f"
"2019","ECK1036-JW5151","yceK",99,1109062,1109242,180,"50M","False","f"
"2021","ECK1037-JW1039","msyB",99,1109284,1109635,351,"50M","False","r"
"2023","ECK1038-JW1040","mdtG",99,1109741,1110944,1203,"50M","False","r"
"2025","ECK1039-JW1041","lpxL",99,1111139,1112036,897,"50M","False","r"
"2027","ECK1040-JW1042","yceA",99,1112266,1113295,1029,"50M","False","f"
"2029","ECK1041-JW1043","yceI",99,1113378,1113930,552,"50M","False","r"
"2031","ECK1042-JW1044","yceJ",99,1113957,1114500,543,"50M","False","r"
"2033","ECK1043-JW1045","yceO",99,1114784,1114901,117,"50M","False","r"
"2035","ECK1044-JW1046","solA",99,1114945,1116040,1095,"50M","False","r"
"2037","ECK1045-JW5152","yceP",99,1116178,1116412,234,"50M","False","r"
"2039","ECK1046-JW1048","dinI",99,1116719,1116941,222,"50M","False","r"
"2041","ECK1047-JW1049","pyrC",99,1117038,1118061,1023,"50M","False","r"
"2043","ECK1048-JW1050","yceB",99,1118190,1118727,537,"50M","False","r"
"2045","ECK1049-JW1051","grxB",99,1118884,1119508,624,"50M","False","r"
"2047","ECK1050-JW1052","mdtH",99,1119595,1120780,1185,"50M","False","r"
"2049","ECK1051-JW1053","rimJ",99,1121021,1121582,561,"50M","False","f"
"2051","ECK1052-JW1054","yceH",99,1121616,1122240,624,"50M","False","f"
"2053","ECK1053-JW1055","mviM",99,1122265,1123165,900,"50M","False","f"
"2055","ECK1054-JW1056","mviN",99,1123298,1124810,1512,"50M","False","f"
"2057","ECK1055-JW1057","flgN",99,1124891,1125284,393,"50M","False","r"
"2059","ECK1056-JW1058","flgM",99,1125315,1125582,267,"50M","False","r"
"2061","ECK1057-JW1059","flgA",99,1125681,1126317,636,"50M","False","r"
"2063","ECK1058-JW1060","flgB",99,1126477,1126870,393,"50M","False","f"
"2065","ECK1059-JW1061","flgC",99,1126897,1127278,381,"50M","False","f"
"2067","ECK1060-JW1062","flgD",99,1127313,1127985,672,"50M","False","f"
"2069","ECK1061-JW1063","flgE",99,1128033,1129218,1185,"50M","False","f"
"2071","ECK1062-JW1064","flgF",99,1129261,1129993,732,"50M","False","f"
"2073","ECK1063-JW1065","flgG",99,1130188,1130947,759,"50M","False","f"
"2075","ECK1064-JW5153","flgH",99,1131014,1131698,684,"50M","False","f"
"2077","ECK1065-JW1067","flgI",99,1131733,1132807,1074,"50M","False","f"
"2079","ECK1066-JW1068","flgJ",99,1132830,1133748,918,"50M","False","f"
"2081","ECK1067-JW1069","flgK",99,1133837,1135457,1620,"50M","False","f"
"2083","ECK1068-JW1070","flgL",99,1135492,1136422,930,"50M","False","f"
"2085","ECK1069-JW1071","rne",99,1136659,1139821,3162,"50M","False","r"
"2087","ECK1070-JW5154","yceQ",99,1139961,1140258,297,"50M","False","f"
"2089","ECK1071-JW1072","rluC",99,1140399,1141335,936,"50M","False","f"
"2091","ECK1072-JW5155","yceF",99,1141488,1142088,600,"50M","False","r"
"2093","ECK1074-JW1074","yceD",99,1142253,1142751,498,"50M","False","f"
"2095","ECK1075-JW1075","rpmF",99,1142826,1142976,150,"50M","False","f"
"2097","ECK1076-JW5156","plsX",99,1143080,1144127,1047,"50M","False","f"
"2099","ECK1077-JW1077","fabH",99,1144218,1145148,930,"50M","False","f"
"2101","ECK1078-JW1078","fabD",99,1145187,1146093,906,"50M","False","f"
"2103","ECK1079-JW1079","fabG",99,1146129,1146840,711,"50M","False","f"
"2105","ECK1080-JW1080","acpP",99,1147074,1147287,213,"50M","False","f"
"2107","ECK1081-JW1081","fabF",99,1147398,1148616,1218,"50M","False","f"
"2109","ECK1082-JW1082","pabC",99,1148759,1149545,786,"50M","False","f"
"2111","ECK1083-JW1083","yceG",99,1149571,1150570,999,"50M","False","f"
"2113","ECK1084-JW1084","tmk",99,1150583,1151201,618,"50M","False","f"
"2115","ECK1085-JW1085","holB",99,1151221,1152202,981,"50M","False","f"
"2117","ECK1086-JW1086","ycfH",99,1152236,1153010,774,"50M","False","f"
"2119","ECK1087-JW1087","ptsG",99,1153328,1154738,1410,"50M","False","f"
"2121","ECK1088-JW1088","fhuE",99,1154839,1157005,2166,"50M","False","r"
"2123","ECK1089-JW1089","hinT",99,1157344,1157680,336,"50M","False","f"
"2125","ECK1090-JW1090","ycfL",99,1157706,1158060,354,"50M","False","f"
"2127","ECK1091-JW5157","ycfM",99,1158094,1158715,621,"50M","False","f"
"2129","ECK1092-JW1092","ycfN",99,1158719,1159520,801,"50M","False","f"
"2131","ECK1093-JW1093","nagZ",99,1159554,1160556,1002,"50M","False","f"
"2133","ECK1094-JW5158","ycfP",99,1160545,1161121,576,"50M","False","f"
"2135","ECK1095-JW1095","ndh",99,1161544,1162825,1281,"50M","False","f"
"2137","ECK1096-JW1096","ycfJ",99,1163058,1163574,516,"50M","False","f"
"2139","ECK1097-JW5159","ycfQ",99,1163677,1164364,687,"50M","False","r"
"2141","ECK1098-JW1098","ycfR",99,1164532,1164766,234,"50M","False","f"
"2143","ECK1099-JW5820","ycfS",99,1164889,1165828,939,"50M","False","r"
"2145","ECK1100-JW1100","mfd",99,1165995,1169418,3423,"50M","False","r"
"2147","ECK1101-JW1101","ycfT",99,1169569,1170619,1050,"50M","False","r"
"2149","ECK1102-JW5161","lolC",99,1170886,1172062,1176,"50M","False","f"
"2151","ECK1103-JW5162","lolD",99,1172078,1172756,678,"50M","False","f"
"2153","ECK1104-JW1104","lolE",99,1172779,1174000,1221,"50M","False","f"
"2155","ECK1105-JW1105","ycfX",99,1174052,1174940,888,"50M","False","f"
"2157","ECK1106-JW1106","cobB",99,1174979,1175795,816,"50M","False","f"
"2159","none-JW5163","none",99,1175813,1175918,105,"50M","False","r"
"2161","ECK1107-JW1107","ycfZ",99,1175956,1176721,765,"50M","False","r"
"2163","ECK1108-JW5164","ymfA",99,1176741,1177188,447,"50M","False","r"
"2165","ECK1109-JW1109","potD",99,1177260,1178283,1023,"50M","False","r"
"2167","ECK1110-JW1110","potC",99,1178303,1179074,771,"50M","False","r"
"2169","ECK1111-JW1111","potB",99,1179094,1179898,804,"50M","False","r"
"2171","ECK1112-JW1112","potA",99,1179935,1181048,1113,"50M","False","r"
"2173","ECK1113-JW1113","pepT",99,1181303,1182506,1203,"50M","False","f"
"2175","ECK1114-JW1114","ycfD",99,1182596,1183694,1098,"50M","False","r"
"2177","ECK1115-JW1115","phoQ",99,1183793,1185230,1437,"50M","False","r"
"2179","ECK1116-JW1116","phoP",99,1185253,1185901,648,"50M","False","r"
"2181","ECK1117-JW1117","purB",99,1186093,1187440,1347,"50M","False","r"
"2183","ECK1118-JW5165","hflD",99,1187467,1188085,618,"50M","False","r"
"2185","ECK1119-JW1119","trmU",99,1188144,1189227,1083,"50M","False","r"
"2187","ECK1120-JW1120","ymfB",99,1189304,1189742,438,"50M","False","r"
"2189","ECK1121-JW1121","ymfC",99,1189775,1190405,630,"50M","False","r"
"2191","ECK1122-JW1122","icd",99,1190582,1191809,1227,"50M","False","f"
"2193","ECK1123-JW1123","ymfD",99,1192344,1192986,642,"50M","False","r"
"2195","ECK1124-JW5166","ymfE",99,1193010,1193700,690,"50M","False","r"
"2197","none-JW5167","none",99,1193986,1194073,87,"50M","False","f"
"2199","ECK1125-JW1125","lit",99,1194154,1195024,870,"50M","False","f"
"2201","ECK1126-JW1126","intE",99,1195156,1196260,1104,"50M","False","r"
"2203","ECK1127-JW1127","ymfG",99,1196264,1196486,222,"50M","False","r"
"2205","ECK1128-JW1128","ymfH",99,1196546,1196834,288,"50M","False","r"
"2207","ECK1129-JW5168","ymfI",99,1196911,1197274,363,"50M","False","f"
"2209","ECK1130-JW1130","ymfJ",99,1197253,1197538,285,"50M","False","r"
"2211","ECK1131-JW1131","ymfK",99,1197736,1198387,651,"50M","False","r"
"2213","ECK1132-JW5169","ymfT",99,1198483,1198660,177,"50M","False","f"
"2215","ECK1133-JW1133","ymfL",99,1198715,1199261,546,"50M","False","f"
"2217","ECK1134-JW1134","ymfM",99,1199281,1199596,315,"50M","False","f"
"2219","ECK1135-JW1135","ymfN",99,1199629,1200973,1344,"50M","False","f"
"2221","ECK1136-JW1136","ymfR",99,1201008,1201167,159,"50M","False","f"
"2223","ECK1137-JW1137","ymfO",99,1201190,1201640,450,"50M","False","f"
"2225","ECK1138-JW5170","ymfP",99,1201551,1202358,807,"50M","False","f"
"2227","ECK1139-JW1139","ymfQ",99,1202372,1202933,561,"50M","False","f"
"2229","ECK1140-JW1140","ycfK",99,1202960,1203566,606,"50M","False","f"
"2231","ECK1141-JW5171","ymfS",99,1203591,1203981,390,"50M","False","f"
"2233","ECK1142-JW1142","tfaE",99,1203994,1204573,579,"50M","False","r"
"2235","ECK1143-JW5172","stfE",99,1204596,1205112,516,"50M","False","r"
"2237","ECK1144-JW1144","pin",99,1205144,1205675,531,"50M","False","f"
"2239","ECK1145-JW1145","mcrA",99,1205805,1206615,810,"50M","False","f"
"2241","ECK1146-JW5173","icdC",99,1206872,1207013,141,"50M","False","f"
"2243","ECK1147-JW1147","elbA",99,1207157,1207457,300,"50M","False","r"
"2245","ECK1148-JW1148","ycgX",99,1208180,1208561,381,"50M","False","r"
"2247","ECK1149-JW1149","ycgE",99,1208805,1209513,708,"50M","False","r"
"2249","ECK1150-JW1150","ycgF",99,1209741,1210929,1188,"50M","False","r"
"2251","ECK1151-JW1151","ycgZ",99,1211248,1211461,213,"50M","False","f"
"2253","ECK1152-JW1152","ymgA",99,1211527,1211776,249,"50M","False","f"
"2255","ECK1153-JW1153","ymgB",99,1211828,1212071,243,"50M","False","f"
"2257","ECK1154-JW1154","ymgC",99,1212207,1212432,225,"50M","False","f"
"2259","ECK1155-JW5174","ycgG",99,1212745,1214287,1542,"50M","False","f"
"2261","ECK1156-JW1156","ymgF",99,1214442,1214637,195,"50M","False","f"
"2263","ECK1157-JW5901","ycgH",99,1215060,1216557,1497,"50M","False","f"
"2265","ECK1157-JW5176","ycgH",99,1216647,1217657,1010,"50M","False","f"
"2267","ECK1158-JW5177","ymgD",99,1217782,1218094,312,"50M","False","r"
"2269","ECK1159-JW5178","ymgG",99,1218121,1218442,321,"50M","False","r"
"2271","ECK1160-JW5179","ymgH",99,1218957,1219122,165,"50M","False","f"
"2273","ECK1161-JW1162","ycgI",99,1219154,1219343,189,"50M","False","f"
"2275","ECK1162-JW1163","minE",99,1219756,1219999,243,"50M","False","r"
"2277","ECK1163-JW1164","minD",99,1220026,1220815,789,"50M","False","r"
"2279","ECK1164-JW1165","minC",99,1220862,1221534,672,"50M","False","r"
"2281","ECK1165-JW1166","ycgJ",99,1222059,1222404,345,"50M","False","f"
"2283","ECK1166-JW1167","ycgK",99,1222548,1222926,378,"50M","False","r"
"2285","ECK1167-JW1168","ycgL",99,1223140,1223443,303,"50M","False","f"
"2287","ECK1168-JW1169","ycgM",99,1223538,1224174,636,"50M","False","f"
"2289","ECK1169-JW5180","ycgN",99,1224259,1224712,453,"50M","False","f"
"2291","ECK1170-JW5181","hlyE",99,1224960,1225854,894,"50M","False","r"
"2293","ECK1171-JW1172","umuD",99,1226226,1226622,396,"50M","False","f"
"2295","ECK1172-JW1173","umuC",99,1226645,1227890,1245,"50M","False","f"
"2297","ECK1173-JW5182","dsbB",99,1227977,1228484,507,"50M","False","r"
"2299","ECK1174-JW1175","nhaB",99,1228653,1230171,1518,"50M","False","r"
"2301","ECK1175-JW1176","fadR",99,1230397,1231093,696,"50M","False","f"
"2303","ECK1176-JW1177","ycgB",99,1231186,1232695,1509,"50M","False","r"
"2305","ECK1177-JW1178","dadA",99,1233030,1234305,1275,"50M","False","f"
"2307","ECK1178-JW1179","dadX",99,1234338,1235385,1047,"50M","False","f"
"2309","none-JW5183","none",99,1235511,1235637,126,"50M","False","f"
"2311","ECK1179-JW5184","cvrA",99,1235812,1237525,1713,"50M","False","r"
"2313","ECK1180-JW1181","ldcA",99,1237643,1238534,891,"50M","False","r"
"2315","ECK1181-JW5821","emtA",99,1238525,1239227,702,"50M","False","f"
"2317","ECK1182-JW1183","ycgR",99,1239270,1239981,711,"50M","False","r"
"2319","ECK1183-JW1184","ymgE",99,1240187,1240418,231,"50M","False","f"
"2321","ECK1184-JW1185","ycgY",99,1240619,1241036,417,"50M","False","f"
"2323","ECK1185-JW1186","treA",99,1241156,1242830,1674,"50M","False","r"
"2325","ECK1186-JW5185","dhaH",99,1243173,1244568,1395,"50M","False","r"
"2327","ECK1187-JW5186","dhaL",99,1244602,1245286,684,"50M","False","r"
"2329","ECK1188-JW5187","dhaK",99,1245245,1246322,1077,"50M","False","r"
"2331","ECK1189-JW5188","dhaR",99,1246525,1248421,1896,"50M","False","f"
"2333","ECK1190-JW1193","ycgV",99,1248562,1251406,2844,"50M","False","r"
"2335","ECK1191-JW1194","ychF",99,1252198,1253266,1068,"50M","False","r"
"2337","ECK1192-JW1195","pth",99,1253406,1253967,561,"50M","False","r"
"2339","ECK1193-JW1196","ychH",99,1254250,1254505,255,"50M","False","f"
"2341","ECK1194-JW5189","ychM",99,1254601,1255903,1302,"50M","False","r"
"2343","ECK1195-JW1198","prsA",99,1256405,1257329,924,"50M","False","r"
"2345","ECK1196-JW1199","ispE",99,1257503,1258331,828,"50M","False","r"
"2347","ECK1197-JW1200","lolB",99,1258354,1258954,600,"50M","False","r"
"2349","ECK1198-JW1201","hemA",99,1259173,1260406,1233,"50M","False","f"
"2351","ECK1199-JW1202","prfA",99,1260471,1261530,1059,"50M","False","f"
"2353","ECK1200-JW1203","prmC",99,1261553,1262363,810,"50M","False","f"
"2355","ECK1201-JW1204","ychQ",99,1262383,1262752,369,"50M","False","f"
"2357","ECK1202-JW1205","ychA",99,1262779,1263565,786,"50M","False","f"
"2359","ECK1203-JW1206","kdsA",99,1263624,1264455,831,"50M","False","f"
"2361","ECK1210-JW1207","chaA",99,1266226,1267303,1077,"50M","False","r"
"2363","ECK1211-JW1208","chaB",99,1267578,1267785,207,"50M","False","f"
"2365","ECK1212-JW1209","chaC",99,1267945,1268638,693,"50M","False","f"
"2367","ECK1213-JW1210","ychN",99,1268723,1269053,330,"50M","False","r"
"2369","ECK1214-JW1211","ychP",99,1269384,1270614,1230,"50M","False","f"
"2371","ECK1215-JW1212","narL",99,1270656,1271283,627,"50M","False","r"
"2373","ECK1216-JW1213","narX",99,1271299,1273072,1773,"50M","False","r"
"2375","none-JW5190","none",99,1273103,1273298,195,"50M","False","f"
"2377","ECK1217-JW1214","narK",99,1273416,1274784,1368,"50M","False","f"
"2379","ECK1218-JW1215","narG",97,1275323,1279043,3720,"50M","False","f"
"2381","ECK1219-JW1216","narH",99,1279063,1280578,1515,"50M","False","f"
"2383","ECK1220-JW1217","narJ",99,1280598,1281285,687,"50M","False","f"
"2385","ECK1221-JW1218","narI",99,1281308,1281962,654,"50M","False","f"
"2387","none-JW5191","none",99,1282343,1282673,330,"50M","False","f"
"2389","ECK1224-JW1219","tpr",99,1282564,1282642,78,"50M","False","r"
"2391","ECK1227-JW1220","purU",99,1283259,1284078,819,"50M","False","r"
"2393","ECK1228-JW1221","ychJ",99,1284151,1284586,435,"50M","False","r"
"2395","ECK1229-JW1222","rssA",99,1284665,1285586,921,"50M","False","f"
"2397","ECK1230-JW1223","rssB",99,1285701,1286691,990,"50M","False","f"
"2399","ECK1231-JW1224","galU",99,1286916,1287801,885,"50M","False","f"
"2401","ECK1232-JW1225","hns",99,1287986,1288376,390,"50M","False","r"
"2403","ECK1233-JW1226","tdk",99,1288986,1289580,594,"50M","False","f"
"2405","ECK1235-JW1228","adhE",99,1290923,1293575,2652,"50M","False","r"
"2407","ECK1236-JW1229","ychE",99,1294057,1294681,624,"50M","False","f"
"2411","ECK1237-JW1235","oppA",99,1295442,1297050,1608,"50M","False","f"
"2413","ECK1238-JW1236","oppB",99,1297159,1298056,897,"50M","False","f"
"2415","ECK1239-JW1237","oppC",99,1298094,1298979,885,"50M","False","f"
"2417","ECK1240-JW1238","oppD",99,1299014,1300004,990,"50M","False","f"
"2419","ECK1241-JW1239","oppF",99,1300024,1301005,981,"50M","False","f"
"2421","ECK1242-JW1240","yciU",99,1301099,1301405,306,"50M","False","r"
"2423","ECK1243-JW1241","cls",99,1301463,1302900,1437,"50M","False","r"
"2425","none-JW5194","none",99,1303015,1303198,183,"50M","False","f"
"2427","ECK1244-JW1242","kch",99,1303294,1304524,1230,"50M","False","r"
"2429","ECK1245-JW1243","yciI",99,1304847,1305120,273,"50M","False","r"
"2431","ECK1246-JW5195","tonB",99,1305349,1306045,696,"50M","False","f"
"2433","ECK1247-JW1245","yciA",99,1306126,1306501,375,"50M","False","r"
"2435","ECK1248-JW1246","yciB",99,1306629,1307145,516,"50M","False","r"
"2437","ECK1249-JW1247","yciC",99,1307198,1307918,720,"50M","False","r"
"2439","ECK1250-JW1248","ompW",99,1308280,1308895,615,"50M","False","f"
"2441","ECK1251-JW1249","yciE",99,1308996,1309479,483,"50M","False","r"
"2443","ECK1252-JW1250","yciF",99,1309548,1310025,477,"50M","False","r"
"2445","ECK1253-JW1251","yciG",99,1310134,1310290,156,"50M","False","r"
"2447","ECK1254-JW1252","trpA",99,1310694,1311477,783,"50M","False","r"
"2449","ECK1255-JW1253","trpB",99,1311500,1312670,1170,"50M","False","r"
"2451","ECK1256-JW1254","trpC",99,1312705,1314040,1335,"50M","False","r"
"2453","ECK1257-JW1255","trpD",99,1314067,1315639,1572,"50M","False","r"
"2455","ECK1258-JW1256","trpE",99,1315662,1317201,1539,"50M","False","r"
"2457","ECK1259-JW1257","trpL",99,1317316,1317337,21,"50M","False","r"
"2459","ECK1260-JW1258","yciV",99,1317480,1318338,858,"50M","False","f"
"2461","ECK1261-JW5196","yciO",99,1318358,1318955,597,"50M","False","f"
"2463","ECK1262-JW5197","yciQ",99,1319150,1320878,1728,"50M","False","f"
"2465","ECK1263-JW1261","rluB",99,1321112,1321964,852,"50M","False","f"
"2467","ECK1264-JW1262","btuR",99,1322045,1322612,567,"50M","False","r"
"2469","ECK1265-JW1263","yciK",99,1322632,1323367,735,"50M","False","r"
"2471","ECK1266-JW1264","sohB",99,1323592,1324618,1026,"50M","False","f"
"2473","ECK1267-JW1265","yciN",99,1324695,1324923,228,"50M","False","r"
"2475","ECK1268-JW1266","topA",99,1325308,1327882,2574,"50M","False","f"
"2477","ECK1269-JW1267","cysB",99,1328115,1329066,951,"50M","False","f"
"2479","ECK1270-JW5198","yciX",99,1329420,1329525,105,"50M","False","f"
"2481","ECK1270-JW5199","yciX",99,1329530,1329695,165,"50M","False","f"
"2483","ECK1271-JW1268","acnA",99,1330091,1332743,2652,"50M","False","f"
"2485","ECK1272-JW1269","ribA",99,1332848,1333415,567,"50M","False","r"
"2487","ECK1273-JW1270","pgpB",99,1333590,1334331,741,"50M","False","f"
"2489","ECK1274-JW1271","yciS",99,1334503,1334788,285,"50M","False","f"
"2491","ECK1275-JW1272","yciM",99,1334818,1335964,1146,"50M","False","f"
"2493","ECK1276-JW1273","pyrF",99,1336181,1336895,714,"50M","False","f"
"2495","ECK1277-JW1274","yciH",99,1336918,1337221,303,"50M","False","f"
"2497","ECK1278-JW1275","osmB",99,1337388,1337583,195,"50M","False","r"
"2499","ECK1279-JW1276","yciT",99,1337875,1338601,726,"50M","False","r"
"2501","ECK1280-JW1278","gmr",99,1339035,1340997,1962,"50M","False","r"
"2503","ECK1281-JW1279","rnb",99,1341256,1343167,1911,"50M","False","r"
"2505","ECK1282-JW5200","yciW",99,1343258,1344440,1182,"50M","False","r"
"2507","ECK1283-JW1281","fabI",99,1344529,1345294,765,"50M","False","r"
"2509","ECK1284-JW1282","ycjD",99,1345685,1346015,330,"50M","False","r"
"2511","ECK1285-JW1283","sapF",99,1346106,1346889,783,"50M","False","r"
"2513","ECK1286-JW1284","sapD",99,1346914,1347883,969,"50M","False","r"
"2515","ECK1287-JW1285","sapC",99,1347906,1348773,867,"50M","False","r"
"2517","ECK1288-JW1286","sapB",99,1348783,1349725,942,"50M","False","r"
"2519","ECK1289-JW1287","sapA",99,1349745,1351365,1620,"50M","False","r"
"2521","ECK1290-JW1288","ymjA",99,1351701,1351923,222,"50M","False","r"
"2523","ECK1291-JW1289","puuP",99,1352080,1353442,1362,"50M","False","r"
"2525","ECK1292-JW5201","puuA",99,1353768,1355163,1395,"50M","False","r"
"2527","ECK1293-JW1291","puuD",99,1355380,1356121,741,"50M","False","f"
"2529","ECK1294-JW1292","puuR",99,1356171,1356705,534,"50M","False","f"
"2531","ECK1295-JW1293","puuC",99,1357003,1358467,1464,"50M","False","f"
"2533","ECK1296-JW1294","puuB",99,1358492,1359749,1257,"50M","False","f"
"2535","ECK1297-JW1295","puuE",99,1359810,1361052,1242,"50M","False","f"
"2537","ECK1298-JW1296","pspF",99,1361213,1362167,954,"50M","False","r"
"2539","ECK1299-JW1297","pspA",99,1362339,1362984,645,"50M","False","f"
"2541","ECK1300-JW1298","pspB",99,1363061,1363262,201,"50M","False","f"
"2543","ECK1301-JW1299","pspC",99,1363285,1363621,336,"50M","False","f"
"2545","ECK1302-JW1300","pspD",99,1363653,1363851,198,"50M","False","f"
"2547","ECK1303-JW1301","pspE",99,1363949,1364240,291,"50M","False","f"
"2549","ECK1304-JW1302","ycjM",99,1364476,1366132,1656,"50M","False","f"
"2551","ECK1305-JW1303","ycjN",99,1366169,1367438,1269,"50M","False","f"
"2553","ECK1306-JW1304","ycjO",99,1367482,1368340,858,"50M","False","f"
"2555","ECK1307-JW1305","ycjP",99,1368350,1369169,819,"50M","False","f"
"2557","ECK1308-JW1306","ycjQ",99,1369223,1370252,1029,"50M","False","f"
"2559","ECK1309-JW5202","ycjR",99,1370285,1371059,774,"50M","False","f"
"2561","ECK1310-JW1308","ycjS",99,1371092,1372124,1032,"50M","False","f"
"2563","ECK1311-JW1309","ycjT",99,1372144,1374388,2244,"50M","False","f"
"2565","ECK1312-JW1310","ycjU",99,1374408,1375044,636,"50M","False","f"
"2567","ECK1313-JW1311","ycjV",99,1375081,1376026,945,"50M","False","f"
"2569","ECK1314-JW5203","ymjB",99,1376049,1376139,90,"50M","False","f"
"2571","ECK1315-JW1312","ompG",99,1376207,1377089,882,"50M","False","f"
"2573","ECK1316-JW1313","ycjW",99,1377241,1378216,975,"50M","False","r"
"2575","ECK1317-JW1314","ycjX",99,1378377,1379751,1374,"50M","False","f"
"2577","ECK1318-JW1315","ycjF",99,1379771,1380809,1038,"50M","False","f"
"2579","ECK1319-JW1316","tyrR",99,1380980,1382498,1518,"50M","False","f"
"2581","ECK1320-JW1317","tpx",99,1382583,1383066,483,"50M","False","r"
"2583","ECK1321-JW1318","ycjG",99,1383190,1384132,942,"50M","False","f"
"2585","ECK1322-JW1319","mpaA",99,1384148,1384913,765,"50M","False","r"
"2587","ECK1323-JW5960","ymjC",99,1384958,1385117,159,"50M","False","r"
"2589","ECK1324-JW5804","ycjY",99,1385211,1386120,909,"50M","False","r"
"2591","ECK1325-JW1321","ycjZ",99,1386251,1387127,876,"50M","False","f"
"2593","ECK1326-JW1322","mppA",99,1387487,1389077,1590,"50M","False","f"
"2595","ECK1327-JW1323","ynaI",99,1389169,1390177,1008,"50M","False","r"
"2597","ECK1328-JW1326","ynaJ",99,1391625,1391859,234,"50M","False","f"
"2599","ECK1329-JW1327","uspE",99,1391950,1392877,927,"50M","False","r"
"2601","ECK1330-JW1328","fnr",99,1393052,1393781,729,"50M","False","r"
"2603","ECK1331-JW1329","ogt",99,1393999,1394491,492,"50M","False","r"
"2605","ECK1332-JW5822","abgT",99,1394525,1396034,1509,"50M","False","r"
"2607","ECK1333-JW1331","abgB",99,1396088,1397510,1422,"50M","False","r"
"2609","ECK1334-JW5205","abgA",99,1397533,1398835,1302,"50M","False","r"
"2611","ECK1335-JW1333","abgR",99,1399001,1399886,885,"50M","False","f"
"2613","ECK1337-JW1334","ydaL",99,1400239,1400779,540,"50M","False","f"
"2615","ECK1338-JW5206","ydaM",99,1400841,1402110,1269,"50M","False","r"
"2617","ECK1339-JW1336","ydaN",99,1402310,1403270,960,"50M","False","f"
"2619","ECK1340-JW1337","dbpA",99,1403771,1405121,1350,"50M","False","f"
"2621","ECK1341-JW1338","ydaO",99,1405291,1406203,912,"50M","False","r"
"2623","ECK1342-JW1339","intR",99,1406278,1407490,1212,"50M","False","r"
"2625","ECK1343-JW5207","ydaQ",99,1407515,1407731,216,"50M","False","r"
"2627","ECK1344-JW1341","ydaC",99,1407809,1407995,186,"50M","False","r"
"2629","ECK1345-JW5208","lar",99,1408011,1408182,171,"50M","False","r"
"2631","ECK1346-JW1343","recT",99,1408262,1409048,786,"50M","False","r"
"2633","ECK1347-JW1344","recE",99,1409064,1411641,2577,"50M","False","r"
"2635","ECK1348-JW1345","racC",99,1411766,1412018,252,"50M","False","r"
"2637","ECK1349-JW1346","ydaE",99,1412116,1412263,147,"50M","False","r"
"2639","ECK1350-JW1347","kil",99,1412286,1412484,198,"50M","False","r"
"2641","ECK1351-JW5209","sieB",99,1412931,1413396,465,"50M","False","f"
"2643","ECK1352-JW1349","ydaF",99,1413434,1413566,132,"50M","False","r"
"2645","ECK1353-JW5210","ydaG",99,1413600,1413756,156,"50M","False","r"
"2647","ECK1354-JW1351","racR",99,1414043,1414496,453,"50M","False","r"
"2649","ECK1355-JW1352","ydaS",99,1414625,1414898,273,"50M","False","f"
"2651","ECK1356-JW1353","ydaT",99,1414944,1415343,399,"50M","False","f"
"2653","ECK1357-JW1354","ydaU",99,1415379,1416213,834,"50M","False","f"
"2655","ECK1358-JW1355","ydaV",99,1416243,1416966,723,"50M","False","f"
"2657","ECK1359-JW5211","ydaW",99,1416961,1417549,588,"50M","False","f"
"2659","ECK1360-JW5212","rzpR",99,1417599,1417881,282,"50M","False","f"
"2661","ECK1361-JW5213","rzoR",99,1417599,1417881,282,"50M","False","f"
"2663","ECK1362-JW1358","trkG",99,1418042,1419476,1434,"50M","False","f"
"2665","ECK1363-JW1359","ynaK",99,1419637,1419877,240,"50M","False","f"
"2667","ECK1364-JW1360","ydaY",99,1419881,1420217,336,"50M","False","f"
"2669","ECK1365-JW1361","ynaA",99,1420714,1421719,1005,"50M","False","f"
"2671","ECK1366-JW5904","lomR",99,1422783,1423221,438,"50M","False","f"
"2673","ECK1367-JW1366","stfR",99,1423309,1426648,3339,"50M","False","f"
"2676","ECK1368-JW1367","tfaR",163,1628538,1629190,652,"50M","False","f"
"2677","ECK1369-JW1368","pinR",99,1427362,1427929,567,"50M","False","r"
"2679","ECK1370-JW1369","ynaE",99,1428269,1428512,243,"50M","False","r"
"2681","ECK1371-JW1370","uspF",99,1429463,1429874,411,"50M","False","r"
"2683","ECK1372-JW1371","ompN",99,1430038,1431148,1110,"50M","False","r"
"2685","ECK1374-JW1372","ydbK",97,1431538,1435039,3501,"50M","False","r"
"2687","ECK1375-JW5215","ydbJ",99,1435429,1435561,132,"50M","False","f"
"2689","ECK1376-JW1374","hslJ",99,1435599,1435998,399,"50M","False","r"
"2691","ECK1377-JW1375","ldhA",99,1436132,1437098,966,"50M","False","r"
"2693","ECK1378-JW1376","ydbH",99,1437311,1439927,2616,"50M","False","f"
"2695","ECK1379-JW1377","ynbE",99,1439947,1440109,162,"50M","False","f"
"2697","ECK1380-JW5216","ydbL",99,1440140,1440443,303,"50M","False","f"
"2699","ECK1381-JW1379","feaR",99,1440656,1441538,882,"50M","False","r"
"2701","ECK1382-JW1380","feaB",99,1441779,1443255,1476,"50M","False","f"
"2703","ECK1383-JW1381","tynA",99,1443354,1445604,2250,"50M","False","r"
"2705","ECK1384-JW1382","maoC",99,1445875,1447897,2022,"50M","False","r"
"2707","ECK1385-JW1383","paaA",99,1448187,1449093,906,"50M","False","f"
"2709","ECK1386-JW1384","paaB",99,1449128,1449392,264,"50M","False","f"
"2711","ECK1387-JW1385","paaC",99,1449424,1450147,723,"50M","False","f"
"2713","ECK1388-JW5217","paaD",99,1450179,1450659,480,"50M","False","f"
"2715","ECK1389-JW1387","paaE",99,1450690,1451737,1047,"50M","False","f"
"2717","ECK1390-JW1388","paaF",99,1451757,1452501,744,"50M","False","f"
"2719","ECK1391-JW1389","paaG",99,1452524,1453289,765,"50M","False","f"
"2721","ECK1392-JW1390","paaH",99,1453314,1454718,1404,"50M","False","f"
"2723","ECK1393-JW1391","paaI",99,1454731,1455130,399,"50M","False","f"
"2725","ECK1394-JW1392","paaJ",99,1455153,1456335,1182,"50M","False","f"
"2727","ECK1395-JW5218","paaK",99,1456385,1457675,1290,"50M","False","f"
"2729","ECK1396-JW1394","paaX",99,1457799,1458726,927,"50M","False","f"
"2731","ECK1397-JW1395","paaY",99,1458731,1459298,567,"50M","False","f"
"2733","ECK1398-JW5802","ydbA",99,1459652,1462187,2535,"50M","False","f"
"2735","ECK1398-JW1402","ydbA",99,1464950,1468250,3300,"50M","False","f"
"2737","ECK1399-JW1403","ydbC",99,1468481,1469318,837,"50M","False","f"
"2739","ECK1400-JW5221","ydbD",99,1469398,1471687,2289,"50M","False","f"
"2741","ECK1401-JW1405","ynbA",99,1471881,1472463,582,"50M","False","f"
"2743","ECK1402-JW1406","ynbB",99,1472486,1473359,873,"50M","False","f"
"2745","ECK1403-JW1407","ynbC",99,1473398,1475132,1734,"50M","False","f"
"2747","ECK1404-JW1408","ynbD",99,1475169,1476438,1269,"50M","False","f"
"2749","ECK1405-JW1409","azoR",99,1476533,1477115,582,"50M","False","r"
"2751","ECK1406-JW5905","hrpA",97,1477378,1481200,3822,"50M","False","f"
"2753","ECK1407-JW1411","ydcF",99,1481495,1482272,777,"50M","False","f"
"2755","ECK1408-JW1412","aldA",99,1482492,1483908,1416,"50M","False","f"
"2757","ECK1409-JW1413","gapC",99,1483991,1484219,228,"50M","False","r"
"2759","ECK1409-JW5906","gapC",99,1484239,1484620,381,"50M","False","r"
"2761","ECK1410-JW5224","cybB",99,1485126,1485669,543,"50M","False","f"
"2763","ECK1411-JW1416","ydcA",99,1485937,1486087,150,"50M","False","f"
"2765","ECK1412-JW5225","hokB",99,1486200,1486326,126,"50M","False","r"
"2767","ECK1415-JW1417","trg",99,1486730,1488347,1617,"50M","False","f"
"2769","ECK1416-JW5226","ydcI",99,1488426,1489467,1041,"50M","False","r"
"2771","ECK1417-JW1419","ydcJ",99,1489548,1490868,1320,"50M","False","f"
"2773","ECK1418-JW1420","mdoD",99,1491146,1492748,1602,"50M","False","f"
"2775","ECK1419-JW5823","ydcH",99,1492968,1493112,144,"50M","False","f"
"2777","ECK1420-JW1423","rimL",99,1493198,1493714,516,"50M","False","f"
"2779","ECK1421-JW1424","ydcK",99,1493747,1494704,957,"50M","False","r"
"2781","ECK1422-JW1425","tehA",99,1494833,1495802,969,"50M","False","f"
"2783","ECK1423-JW1426","tehB",99,1495822,1496392,570,"50M","False","f"
"2785","ECK1424-JW1427","ydcL",99,1496717,1497362,645,"50M","False","f"
"2787","ECK1425-JW5227","yncK",99,1497421,1497565,144,"50M","False","r"
"2789","ECK1425-JW5961","yncK",99,1497640,1497904,264,"50M","False","r"
"2791","ECK1426-JW5228","ydcM",99,1497977,1499102,1125,"50M","False","f"
"2793","ECK1427-JW5229","ydcO",99,1499183,1500458,1275,"50M","False","r"
"2795","ECK1428-JW1430","ydcN",99,1500432,1500945,513,"50M","False","f"
"2797","ECK1429-JW1431","ydcP",99,1501041,1502979,1938,"50M","False","f"
"2799","ECK1430-JW1432","yncJ",99,1503112,1503319,207,"50M","False","r"
"2801","ECK1431-JW5230","yncN",99,1503546,1503699,153,"50M","False","f"
"2803","ECK1432-JW1433","ydcQ",99,1503747,1504161,414,"50M","False","f"
"2805","ECK1433-JW1434","ydcR",99,1504263,1505646,1383,"50M","False","f"
"2807","ECK1434-JW1435","ydcS",99,1505914,1507036,1122,"50M","False","f"
"2809","ECK1435-JW1436","ydcT",99,1507077,1508067,990,"50M","False","f"
"2811","ECK1436-JW1437","ydcU",99,1508091,1509009,918,"50M","False","f"
"2813","ECK1437-JW1438","ydcV",99,1509022,1509793,771,"50M","False","f"
"2815","ECK1438-JW1439","ydcW",99,1509838,1511239,1401,"50M","False","f"
"2817","none-JW5231","none",99,1511293,1511467,174,"50M","False","f"
"2819","ECK1439-JW5232","ydcX",99,1511574,1511799,225,"50M","False","f"
"2821","ECK1440-JW1441","ydcY",99,1511908,1512118,210,"50M","False","f"
"2823","ECK1441-JW1442","ydcZ",99,1512160,1512586,426,"50M","False","r"
"2825","ECK1442-JW5233","yncA",99,1512606,1513101,495,"50M","False","r"
"2827","ECK1443-JW5907","yncB",99,1513263,1514301,1038,"50M","False","f"
"2829","ECK1444-JW1445","yncC",99,1514522,1515164,642,"50M","False","f"
"2831","ECK1445-JW1446","yncD",99,1515241,1517320,2079,"50M","False","r"
"2833","ECK1446-JW1447","yncE",99,1517567,1518605,1038,"50M","False","f"
"2835","ECK1447-JW5234","ansP",99,1518759,1520235,1476,"50M","False","r"
"2837","ECK1448-JW1449","yncG",99,1520507,1521101,594,"50M","False","f"
"2839","ECK1449-JW5235","yncH",99,1521287,1521389,102,"50M","False","f"
"2841","none-JW5236","none",99,1521837,1521927,90,"50M","False","f"
"2843","ECK1450-JW1451","rhsE",99,1522150,1524175,2025,"50M","False","f"
"2845","ECK1451-JW1452","ydcD",99,1524182,1524641,459,"50M","False","f"
"2847","ECK1452-JW1453","yncI",99,1524846,1525569,723,"50M","False","f"
"2849","ECK1453-JW5237","yncM",99,1525711,1525813,102,"50M","False","f"
"2851","ECK1454-JW1455","ydcC",99,1526076,1527189,1113,"50M","False","f"
"2853","ECK1455-JW1456","ydcE",99,1527312,1527522,210,"50M","False","f"
"2855","ECK1456-JW1457","yddH",99,1527560,1528106,546,"50M","False","r"
"2857","ECK1457-JW1458","nhoA",99,1528284,1529106,822,"50M","False","f"
"2859","ECK1458-JW1459","yddE",99,1529243,1530113,870,"50M","False","r"
"2861","ECK1459-JW1460","narV",99,1530215,1530872,657,"50M","False","r"
"2863","ECK1460-JW1461","narW",99,1530892,1531564,672,"50M","False","r"
"2865","ECK1461-JW1462","narY",99,1531587,1533108,1521,"50M","False","r"
"2867","ECK1462-JW1463","narZ",97,1533128,1536845,3717,"50M","False","r"
"2869","ECK1463-JW1464","narU",99,1536950,1538315,1365,"50M","False","r"
"2871","ECK1464-JW1466","yddJ",99,1538662,1538974,312,"50M","False","r"
"2873","ECK1465-JW1467","yddK",99,1539036,1539969,933,"50M","False","r"
"2875","ECK1466-JW1468","yddL",99,1540016,1540283,267,"50M","False","r"
"2877","ECK1467-JW1469","yddG",99,1540566,1541367,801,"50M","False","r"
"2879","ECK1468-JW1470","fdnG",99,1541661,1544685,3024,"50M","False","f"
"2881","ECK1469-JW1471","fdnH",99,1544721,1545582,861,"50M","False","f"
"2883","ECK1470-JW1472","fdnI",99,1545598,1546228,630,"50M","False","f"
"2885","ECK1471-JW5908","yddM",99,1546676,1547015,339,"50M","False","r"
"2887","ECK1472-JW1474","adhP",99,1547106,1548093,987,"50M","False","r"
"2889","ECK1473-JW5238","sfcA",99,1548250,1549951,1701,"50M","False","r"
"2891","ECK1474-JW5962","sra",99,1550104,1550218,114,"50M","False","r"
"2893","ECK1475-JW5239","bdm",99,1550343,1550598,255,"50M","False","r"
"2895","ECK1476-JW1477","osmC",99,1550885,1551293,408,"50M","False","f"
"2897","ECK1477-JW1478","ddpF",99,1551390,1552293,903,"50M","False","r"
"2899","ECK1478-JW1479","ddpD",99,1552309,1553272,963,"50M","False","r"
"2901","ECK1479-JW1480","ddpC",99,1553292,1554165,873,"50M","False","r"
"2903","ECK1480-JW1481","ddpB",99,1554185,1555184,999,"50M","False","r"
"2905","ECK1481-JW5240","ddpA",99,1555209,1556874,1665,"50M","False","r"
"2907","ECK1482-JW1483","ddpX",99,1556773,1557331,558,"50M","False","r"
"2909","ECK1483-JW1484","dos",99,1557612,1559988,2376,"50M","False","r"
"2911","ECK1484-JW5241","yddV",99,1560036,1561395,1359,"50M","False","r"
"2913","ECK1485-JW1486","yddW",99,1561782,1563078,1296,"50M","False","r"
"2915","ECK1486-JW1487","gadC",99,1563232,1564744,1512,"50M","False","r"
"2917","ECK1487-JW1488","gadB",99,1564923,1566300,1377,"50M","False","r"
"2919","ECK1488-JW1489","pqqL",99,1566685,1569457,2772,"50M","False","r"
"2921","ECK1489-JW1490","yddB",99,1569525,1571874,2349,"50M","False","r"
"2923","ECK1490-JW5242","yddA",99,1571935,1573597,1662,"50M","False","r"
"2925","ECK1491-JW1492","ydeM",99,1573911,1575045,1134,"50M","False","r"
"2927","ECK1492-JW5243","ydeN",99,1575120,1576779,1659,"50M","False","r"
"2929","ECK1493-JW1494","ydeO",99,1577204,1577942,738,"50M","False","r"
"2931","ECK1494-JW1495","ydeP",99,1578485,1580741,2256,"50M","False","r"
"2933","ECK1495-JW1496","ydeQ",99,1581098,1581989,891,"50M","False","r"
"2935","ECK1496-JW1497","ydeR",99,1582071,1582551,480,"50M","False","r"
"2937","ECK1497-JW1498","ydeS",99,1582587,1583094,507,"50M","False","r"
"2939","ECK1498-JW1499","ydeT",99,1583131,1584256,1125,"50M","False","r"
"2941","ECK1499-JW5244","yneL",99,1584635,1584791,156,"50M","False","r"
"2943","ECK1500-JW1500","hipA",99,1585132,1586431,1299,"50M","False","r"
"2945","ECK1501-JW1501","hipB",99,1586454,1586697,243,"50M","False","r"
"2947","ECK1502-JW1502","ydeU",99,1586943,1588320,1377,"50M","False","r"
"2949","ECK1503-JW1503","ydeK",97,1588387,1592341,3954,"50M","False","r"
"2951","ECK1504-JW1504","ydeV",99,1592895,1594464,1569,"50M","False","r"
"2953","ECK1505-JW1505","ydeW",99,1594566,1595496,930,"50M","False","r"
"2955","ECK1506-JW1506","ego",99,1595750,1597262,1512,"50M","False","f"
"2957","ECK1507-JW1507","lsrC",99,1597279,1598284,1005,"50M","False","f"
"2959","ECK1508-JW1508","lsrD",99,1598307,1599276,969,"50M","False","f"
"2961","ECK1509-JW1509","lsrB",99,1599311,1600310,999,"50M","False","f"
"2963","ECK1510-JW1510","lsrF",99,1600360,1601212,852,"50M","False","f"
"2965","ECK1511-JW1511","lsrG",99,1601259,1601526,267,"50M","False","f"
"2967","ECK1512-JW1512","tam",99,1601606,1602341,735,"50M","False","f"
"2969","ECK1513-JW5245","yneE",99,1602386,1603328,942,"50M","False","r"
"2971","ECK1514-JW1514","uxaB",99,1603507,1604935,1428,"50M","False","r"
"2973","ECK1515-JW5825","yneF",99,1605185,1606061,876,"50M","False","r"
"2975","ECK1516-JW1516","yneG",99,1606244,1606580,336,"50M","False","r"
"2977","ECK1517-JW1517","yneH",99,1606603,1607506,903,"50M","False","r"
"2979","ECK1518-JW5247","yneI",99,1607593,1608982,1389,"50M","False","r"
"2981","ECK1519-JW1519","yneJ",99,1609064,1609922,858,"50M","False","f"
"2983","ECK1520-JW1520","yneK",99,1610023,1611115,1092,"50M","False","f"
"2985","ECK1521-JW1521","ydeA",99,1611288,1612455,1167,"50M","False","f"
"2987","ECK1522-JW1522","marC",99,1612521,1613163,642,"50M","False","r"
"2989","ECK1523-JW5248","marR",99,1613437,1613791,354,"50M","False","f"
"2991","ECK1524-JW5249","marA",99,1613828,1614194,366,"50M","False","f"
"2993","ECK1525-JW1525","marB",99,1614249,1614444,195,"50M","False","f"
"2995","ECK1526-JW5250","eamA",99,1614516,1615293,777,"50M","False","r"
"2997","ECK1527-JW1527","ydeE",99,1615592,1616756,1164,"50M","False","f"
"2999","ECK1528-JW1528","ydeH",99,1617238,1618105,867,"50M","False","r"
"3001","ECK1529-JW1529","ydeI",99,1618383,1618752,369,"50M","False","r"
"3003","ECK1530-JW1530","ydeJ",99,1619033,1619528,495,"50M","False","f"
"3005","ECK1531-JW1531","dcp",99,1619613,1621635,2022,"50M","False","r"
"3007","ECK1532-JW1532","ydfG",99,1621777,1622500,723,"50M","False","f"
"3009","ECK1533-JW1533","ydfH",99,1622612,1623275,663,"50M","False","f"
"3011","ECK1534-JW1534","ydfZ",99,1623475,1623655,180,"50M","False","f"
"3013","ECK1535-JW1535","ydfI",99,1623731,1625168,1437,"50M","False","r"
"3015","ECK1536-JW1536","ydfJ",99,1625280,1626540,1260,"50M","False","r"
"3017","ECK1537-JW1537","ydfK",99,1627299,1627542,243,"50M","False","f"
"3019","ECK1538-JW1538","pinQ",99,1627882,1628449,567,"50M","False","f"
"3022","ECK1539-JW1539","tfaQ",163,1426621,1427273,652,"50M","False","r"
"3023","ECK1540-JW1540","stfQ",99,1629163,1630102,939,"50M","False","r"
"3025","ECK1541-JW1541","nohA",99,1630076,1630622,546,"50M","False","r"
"3027","ECK1542-JW5251","ynfO",99,1631016,1631226,210,"50M","False","f"
"3029","ECK1543-JW5252","ydfO",99,1631307,1631694,387,"50M","False","f"
"3031","ECK1544-JW5253","gnsB",99,1631887,1632040,153,"50M","False","r"
"3033","ECK1545-JW5254","ynfN",99,1632232,1632364,132,"50M","False","r"
"3035","ECK1546-JW1544","cspI",99,1632733,1632922,189,"50M","False","r"
"3037","ECK1547-JW1545","ydfP",99,1633308,1633782,474,"50M","False","r"
"3039","ECK1548-JW1546","ydfQ",99,1633802,1634312,510,"50M","False","r"
"3041","ECK1549-JW1547","ydfR",99,1634332,1634620,288,"50M","False","r"
"3043","ECK1550-JW5255","essQ",99,1634648,1634840,192,"50M","False","r"
"3045","ECK1551-JW1549","cspB",99,1635617,1635809,192,"50M","False","r"
"3047","ECK1552-JW1550","cspF",99,1636115,1636304,189,"50M","False","f"
"3049","ECK1553-JW1551","ydfT",99,1636767,1637496,729,"50M","False","r"
"3051","ECK1554-JW5909","ydfU",99,1637533,1638559,1026,"50M","False","r"
"3053","ECK1555-JW1553","rem",99,1638929,1639157,228,"50M","False","r"
"3055","ECK1556-JW1554","hokD",99,1639397,1639529,132,"50M","False","r"
"3057","ECK1557-JW1555","relE",99,1639624,1639888,264,"50M","False","r"
"3059","ECK1558-JW1556","relB",99,1639911,1640127,216,"50M","False","r"
"3061","ECK1559-JW1557","ydfV",99,1640157,1640439,282,"50M","False","f"
"3063","ECK1560-JW1558","flxA",99,1640665,1640974,309,"50M","False","f"
"3065","ECK1561-JW1559","ydfW",99,1641452,1641578,126,"50M","False","r"
"3067","ECK1562-JW1560","ydfX",99,1641624,1641891,267,"50M","False","r"
"3069","ECK1563-JW1561","dicC",99,1641898,1642105,207,"50M","False","r"
"3071","ECK1564-JW1562","dicA",99,1642194,1642578,384,"50M","False","f"
"3073","ECK1565-JW1563","ydfA",99,1642768,1642900,132,"50M","False","f"
"3075","ECK1566-JW1564","ydfB",99,1642925,1643030,105,"50M","False","f"
"3077","ECK1567-JW1565","ydfC",99,1643083,1643278,195,"50M","False","f"
"3079","ECK1569-JW1566","dicB",99,1643869,1644034,165,"50M","False","f"
"3081","ECK1570-JW1567","ydfD",99,1644054,1644222,168,"50M","False","f"
"3083","ECK1571-JW1568","ydfE",99,1644338,1645235,897,"50M","False","f"
"3085","ECK1573-JW1571","intQ",99,1645772,1646945,1173,"50M","False","f"
"3087","ECK1574-JW5257","ynfP",99,1647006,1647093,87,"50M","False","r"
"3089","ECK1575-JW1572","rspB",99,1647174,1648170,996,"50M","False","r"
"3091","ECK1576-JW1573","rspA",99,1648205,1649396,1191,"50M","False","r"
"3093","ECK1577-JW1574","ynfA",99,1649625,1649928,303,"50M","False","r"
"3095","ECK1578-JW1575","ynfB",99,1650068,1650386,318,"50M","False","f"
"3097","ECK1579-JW1576","speG",99,1650444,1650981,537,"50M","False","f"
"3099","ECK1580-JW5258","ynfC",99,1651025,1651748,723,"50M","False","r"
"3101","ECK1581-JW5259","ynfD",99,1651825,1652107,282,"50M","False","f"
"3103","ECK1582-JW1579","ynfE",99,1652329,1654732,2403,"50M","False","f"
"3105","ECK1583-JW5260","ynfF",99,1654816,1657216,2400,"50M","False","f"
"3107","ECK1584-JW1581","ynfG",99,1657250,1657844,594,"50M","False","f"
"3109","ECK1585-JW5261","ynfH",99,1657869,1658700,831,"50M","False","f"
"3111","ECK1586-JW5262","dmsD",99,1658766,1659357,591,"50M","False","f"
"3113","ECK1587-JW5263","clcB",99,1659575,1660808,1233,"50M","False","f"
"3115","ECK1588-JW5264","ynfK",99,1660802,1661474,672,"50M","False","r"
"3117","ECK1589-JW1586","dgsA",99,1661622,1662819,1197,"50M","False","r"
"3119","ECK1590-JW1587","ynfL",99,1662977,1663847,870,"50M","False","r"
"3121","ECK1591-JW1588","ynfM",99,1663959,1665189,1230,"50M","False","f"
"3123","ECK1592-JW5826","asr",99,1665609,1665921,312,"50M","False","f"
"3125","ECK1593-JW1590","ydgD",99,1666220,1667018,798,"50M","False","f"
"3127","ECK1594-JW1591","mdtI",99,1667098,1667404,306,"50M","False","r"
"3129","ECK1595-JW1592","mdtJ",99,1667414,1667756,342,"50M","False","r"
"3131","ECK1596-JW1593","ydgG",99,1668173,1669184,1011,"50M","False","f"
"3133","ECK1597-JW1594","pntB",99,1669250,1670615,1365,"50M","False","r"
"3135","ECK1598-JW1595","pntA",99,1670649,1672158,1509,"50M","False","r"
"3137","ECK1599-JW1596","ydgH",99,1672687,1673608,921,"50M","False","f"
"3139","ECK1600-JW1597","ydgI",99,1673817,1675176,1359,"50M","False","f"
"3141","ECK1601-JW1598","folM",99,1675236,1675935,699,"50M","False","f"
"3143","ECK1602-JW1599","ydgC",99,1675973,1676285,312,"50M","False","r"
"3145","ECK1603-JW1600","rstA",99,1676410,1677115,705,"50M","False","f"
"3147","ECK1604-JW1601","rstB",99,1677142,1678420,1278,"50M","False","f"
"3149","ECK1605-JW1602","tus",99,1678519,1679425,906,"50M","False","f"
"3151","ECK1606-JW1603","fumC",99,1679463,1680843,1380,"50M","False","r"
"3153","ECK1607-JW1604","fumA",99,1681009,1682632,1623,"50M","False","r"
"3155","ECK1608-JW1605","manA",99,1682836,1683988,1152,"50M","False","f"
"3157","ECK1609-JW1606","ydgA",99,1684112,1685597,1485,"50M","False","f"
"3159","ECK1610-JW1607","uidC",99,1685864,1687106,1242,"50M","False","r"
"3161","ECK1611-JW1608","uidB",99,1687168,1688518,1350,"50M","False","r"
"3163","ECK1612-JW1609","uidA",99,1688538,1690326,1788,"50M","False","r"
"3165","ECK1613-JW1610","uidR",99,1690740,1691307,567,"50M","False","r"
"3167","ECK1614-JW1611","hdhA",99,1691551,1692295,744,"50M","False","r"
"3169","ECK1615-JW1612","malI",99,1692430,1693435,1005,"50M","False","r"
"3171","ECK1616-JW1613","malX",99,1693615,1695184,1569,"50M","False","f"
"3173","ECK1617-JW1614","malY",99,1695217,1696366,1149,"50M","False","f"
"3175","ECK1618-JW1615","add",99,1696493,1697471,978,"50M","False","f"
"3177","ECK1619-JW5265","ydgJ",99,1697546,1698602,1056,"50M","False","r"
"3179","ECK1620-JW5963","blr",99,1698811,1698913,102,"50M","False","f"
"3181","ECK1621-JW1617","ydgT",99,1699209,1699401,192,"50M","False","f"
"3183","ECK1622-JW1618","ydgK",99,1699510,1699927,417,"50M","False","f"
"3185","ECK1623-JW1619","rsxA",99,1700027,1700585,558,"50M","False","f"
"3187","ECK1624-JW1620","rsxB",99,1700608,1701163,555,"50M","False","f"
"3189","ECK1625-JW1621","rsxC",99,1701179,1703378,2199,"50M","False","f"
"3191","ECK1626-JW1622","rsxD",99,1703402,1704437,1035,"50M","False","f"
"3193","ECK1627-JW1623","rsxG",99,1704464,1705061,597,"50M","False","f"
"3195","ECK1628-JW1624","rsxE",99,1705088,1705760,672,"50M","False","f"
"3197","ECK1629-JW1625","nth",99,1705783,1706395,612,"50M","False","f"
"3199","none-JW5266","none",99,1706546,1706723,177,"50M","False","f"
"3201","ECK1630-JW1626","ydgR",99,1707029,1708508,1479,"50M","False","f"
"3203","ECK1631-JW1627","gst",99,1708637,1709219,582,"50M","False","f"
"3205","ECK1632-JW1628","pdxY",99,1709304,1710144,840,"50M","False","r"
"3207","ECK1633-JW1629","tyrS",99,1710226,1711477,1251,"50M","False","r"
"3209","ECK1634-JW1630","pdxH",99,1711629,1712262,633,"50M","False","r"
"3211","ECK1635-JW1631","ydhA",99,1712344,1712650,306,"50M","False","r"
"3213","ECK1636-JW1632","ydhH",99,1712771,1713857,1086,"50M","False","r"
"3215","ECK1637-JW1633","slyB",99,1714136,1714580,444,"50M","False","f"
"3217","ECK1638-JW5267","slyA",99,1714668,1715085,417,"50M","False","r"
"3219","ECK1639-JW1635","ydhI",99,1715285,1715498,213,"50M","False","f"
"3221","ECK1640-JW1636","ydhJ",99,1715524,1716358,834,"50M","False","f"
"3223","ECK1641-JW1637","ydhK",99,1716381,1718370,1989,"50M","False","f"
"3225","ECK1642-JW1638","sodC",99,1718412,1718910,498,"50M","False","r"
"3227","ECK1643-JW1639","ydhF",99,1719014,1719887,873,"50M","False","r"
"3229","ECK1644-JW5827","ydhL",99,1719959,1720346,387,"50M","False","r"
"3231","ECK1645-JW5874","ydhM",99,1720367,1720859,492,"50M","False","f"
"3233","ECK1646-JW1642","nemA",99,1720919,1721993,1074,"50M","False","f"
"3235","ECK1647-JW1643","gloA",99,1722097,1722481,384,"50M","False","f"
"3237","ECK1648-JW1644","rnt",99,1722607,1723231,624,"50M","False","f"
"3239","ECK1649-JW1645","lhr",97,1723347,1727940,4593,"50M","False","f"
"3241","ECK1650-JW1646","ydhD",99,1728032,1728356,324,"50M","False","r"
"3243","ECK1651-JW5270","ydhO",99,1728764,1729487,723,"50M","False","f"
"3245","ECK1652-JW1648","sodB",99,1729638,1730196,558,"50M","False","f"
"3247","ECK1653-JW1649","ydhP",99,1730399,1731545,1146,"50M","False","r"
"3249","ECK1654-JW1650","purR",99,1732104,1733106,1002,"50M","False","f"
"3251","ECK1655-JW1651","ydhB",99,1733144,1734053,909,"50M","False","r"
"3253","ECK1656-JW1652","ydhC",99,1734171,1735359,1188,"50M","False","f"
"3255","ECK1657-JW1653","cfa",99,1735673,1736798,1125,"50M","False","f"
"3257","ECK1658-JW1654","ribC",99,1736879,1737497,618,"50M","False","r"
"3259","ECK1659-JW1655","mdtK",99,1737717,1739067,1350,"50M","False","f"
"3261","ECK1660-JW1656","ydhQ",99,1739152,1740382,1230,"50M","False","r"
"3263","ECK1663-JW1657","ydhR",99,1740960,1741242,282,"50M","False","f"
"3265","ECK1664-JW1658","ydhS",99,1741391,1742972,1581,"50M","False","f"
"3267","ECK1665-JW1659","ydhT",99,1743025,1743814,789,"50M","False","r"
"3269","ECK1666-JW1660","ydhU",99,1743841,1744603,762,"50M","False","r"
"3271","ECK1667-JW5271","ydhX",99,1744623,1745268,645,"50M","False","r"
"3273","ECK1668-JW1662","ydhW",99,1745355,1745979,624,"50M","False","r"
"3275","ECK1669-JW5272","ydhV",99,1746006,1748169,2163,"50M","False","r"
"3277","ECK1670-JW1664","ydhY",99,1748129,1748732,603,"50M","False","r"
"3279","ECK1671-JW1665","ydhZ",99,1749210,1749396,186,"50M","False","r"
"3281","ECK1672-JW1666","pykF",99,1749958,1751347,1389,"50M","False","f"
"3283","ECK1673-JW1667","lpp",99,1751681,1751894,213,"50M","False","f"
"3285","ECK1674-JW1668","ynhG",99,1751999,1752980,981,"50M","False","r"
"3287","ECK1675-JW1669","sufE",99,1753152,1753545,393,"50M","False","r"
"3289","ECK1676-JW1670","sufS",99,1753581,1754778,1197,"50M","False","r"
"3291","ECK1677-JW1671","sufD",99,1754798,1756046,1248,"50M","False","r"
"3293","ECK1678-JW1672","sufC",99,1756044,1756767,723,"50M","False","r"
"3295","ECK1679-JW5273","sufB",99,1756800,1758303,1503,"50M","False","r"
"3297","ECK1680-JW1674","sufA",99,1758296,1758641,345,"50M","False","r"
"3299","ECK1682-JW1675","ydiH",99,1759212,1759458,246,"50M","False","r"
"3301","ECK1683-JW1676","ydiI",99,1759500,1759887,387,"50M","False","r"
"3303","ECK1684-JW1677","ydiJ",99,1759907,1762940,3033,"50M","False","r"
"3305","ECK1685-JW1678","ydiK",99,1763334,1764423,1089,"50M","False","f"
"3307","ECK1687-JW1679","ydiL",99,1764875,1765208,333,"50M","False","f"
"3309","ECK1688-JW1680","ydiM",99,1765331,1766522,1191,"50M","False","f"
"3311","ECK1689-JW5274","ydiN",99,1766772,1768014,1242,"50M","False","f"
"3313","ECK1690-JW1682","ydiB",99,1768049,1768892,843,"50M","False","f"
"3315","ECK1691-JW1683","aroD",99,1768946,1769681,735,"50M","False","f"
"3317","ECK1692-JW1684","ydiF",99,1769847,1771419,1572,"50M","False","f"
"3319","ECK1693-JW5275","ydiO",99,1771402,1772584,1182,"50M","False","f"
"3321","ECK1694-JW1686","ydiP",99,1772668,1773556,888,"50M","False","r"
"3323","ECK1695-JW5276","ydiQ",99,1773778,1774618,840,"50M","False","f"
"3325","ECK1696-JW1688","ydiR",99,1774661,1775576,915,"50M","False","f"
"3327","ECK1697-JW1689","ydiS",99,1775655,1776921,1266,"50M","False","f"
"3329","ECK1698-JW1690","ydiT",99,1776941,1777211,270,"50M","False","f"
"3331","ECK1699-JW5910","ydiD",99,1777237,1778914,1677,"50M","False","f"
"3333","ECK1700-JW1692","pps",99,1779012,1781367,2355,"50M","False","r"
"3335","ECK1701-JW1693","ydiA",99,1781705,1782515,810,"50M","False","f"
"3337","ECK1702-JW1694","aroH",99,1782695,1783718,1023,"50M","False","f"
"3339","ECK1703-JW1695","ydiE",99,1783873,1784041,168,"50M","False","f"
"3341","ECK1704-JW1696","ydiU",99,1784086,1785499,1413,"50M","False","r"
"3343","ECK1705-JW1697","ydiV",99,1785585,1786275,690,"50M","False","r"
"3345","ECK1706-JW1698","nlpC",99,1786545,1786986,441,"50M","False","r"
"3347","ECK1707-JW1699","btuD",99,1787087,1787813,726,"50M","False","r"
"3349","ECK1708-JW1700","btuE",99,1787836,1788364,528,"50M","False","r"
"3351","ECK1709-JW1701","btuC",99,1788450,1789407,957,"50M","False","r"
"3353","ECK1710-JW1702","ihfA",99,1789531,1789807,276,"50M","False","r"
"3355","ECK1711-JW1703","pheT",99,1789835,1792199,2364,"50M","False","r"
"3357","ECK1712-JW5277","pheS",99,1792237,1793197,960,"50M","False","r"
"3359","ECK1713-JW1705","pheM",99,1793504,1793525,21,"50M","False","r"
"3361","ECK1714-JW1706","rplT",99,1793671,1794004,333,"50M","False","r"
"3363","ECK1715-JW1707","rpmI",99,1794080,1794254,174,"50M","False","r"
"3365","ECK1716-JW5829","infC",99,1794374,1794893,519,"50M","False","r"
"3367","ECK1717-JW1709","thrS",99,1794920,1796825,1905,"50M","False","r"
"3369","ECK1718-JW5278","arpB",99,1797354,1797804,450,"50M","False","f"
"3371","ECK1718-JW1710","arpB",99,1797838,1799230,1392,"50M","False","f"
"3373","ECK1719-JW5911","yniD",99,1799425,1799509,84,"50M","False","f"
"3375","ECK1720-JW1711","ydiY",99,1799603,1800338,735,"50M","False","r"
"3377","ECK1721-JW5280","pfkB",99,1800627,1801536,909,"50M","False","f"
"3379","ECK1722-JW1713","ydiZ",99,1801660,1801927,267,"50M","False","f"
"3381","ECK1723-JW1714","yniA",99,1802056,1802893,837,"50M","False","f"
"3383","ECK1724-JW1715","yniB",99,1802975,1803488,513,"50M","False","r"
"3385","ECK1725-JW1716","yniC",99,1803640,1804285,645,"50M","False","f"
"3387","ECK1726-JW5281","ydjM",99,1804471,1805038,567,"50M","False","f"
"3389","ECK1727-JW1718","ydjN",99,1805194,1806562,1368,"50M","False","f"
"3391","ECK1728-JW1719","ydjO",99,1806607,1807399,792,"50M","False","r"
"3393","ECK1729-JW1720","cedA",99,1807699,1807939,240,"50M","False","r"
"3395","ECK1730-JW1721","katE",99,1808127,1810365,2238,"50M","False","f"
"3397","ECK1731-JW1722","chbG",99,1810664,1811390,726,"50M","False","r"
"3399","ECK1732-JW1723","chbF",99,1811426,1812755,1329,"50M","False","r"
"3401","ECK1733-JW1724","chbR",99,1812883,1813702,819,"50M","False","r"
"3403","ECK1734-JW1725","chbA",99,1813733,1814060,327,"50M","False","r"
"3405","ECK1735-JW1726","chbC",99,1814134,1815469,1335,"50M","False","r"
"3407","ECK1736-JW1727","chbB",99,1815577,1815874,297,"50M","False","r"
"3409","ECK1737-JW1728","osmE",99,1816196,1816511,315,"50M","False","r"
"3411","ECK1738-JW1729","nadE",99,1816718,1817522,804,"50M","False","f"
"3413","ECK1739-JW1730","ydjQ",99,1817775,1818639,864,"50M","False","f"
"3415","ECK1740-JW1731","ydjR",99,1818640,1819192,552,"50M","False","r"
"3417","ECK1741-JW1732","spy",99,1819418,1819880,462,"50M","False","r"
"3419","ECK1742-JW1733","astE",99,1820233,1821178,945,"50M","False","r"
"3421","ECK1743-JW1734","astB",99,1821194,1822514,1320,"50M","False","r"
"3423","ECK1744-JW5282","astD",99,1822534,1823989,1455,"50M","False","r"
"3425","ECK1745-JW1736","astA",99,1824009,1825020,1011,"50M","False","r"
"3427","ECK1746-JW1737","astC",99,1825040,1826237,1197,"50M","False","r"
"3429","ECK1747-JW1738","xthA",99,1826688,1827471,783,"50M","False","f"
"3431","ECK1748-JW1739","ydjX",99,1827661,1828348,687,"50M","False","f"
"3433","ECK1749-JW5283","ydjY",99,1828376,1829030,654,"50M","False","f"
"3435","ECK1750-JW1741","ydjZ",99,1829068,1829752,684,"50M","False","f"
"3437","ECK1751-JW1742","ynjA",99,1829775,1830300,525,"50M","False","f"
"3439","ECK1752-JW5284","ynjB",99,1830330,1831476,1146,"50M","False","f"
"3441","ECK1753-JW5285","ynjC",99,1831517,1832984,1467,"50M","False","f"
"3443","ECK1754-JW5286","ynjD",99,1833007,1833637,630,"50M","False","f"
"3445","ECK1755-JW5287","ynjE",99,1833712,1835011,1299,"50M","False","f"
"3447","ECK1756-JW1747","ynjF",99,1835061,1835658,597,"50M","False","r"
"3449","ECK1757-JW1748","nudG",99,1835750,1836134,384,"50M","False","f"
"3451","ECK1758-JW1749","ynjH",99,1836141,1836390,249,"50M","False","r"
"3453","ECK1759-JW1750","gdhA",99,1836631,1837951,1320,"50M","False","f"
"3455","ECK1760-JW5288","ynjI",99,1838109,1839249,1140,"50M","False","r"
"3457","ECK1761-JW1752","topB",99,1839277,1841215,1938,"50M","False","r"
"3459","ECK1762-JW1753","selD",99,1841243,1842263,1020,"50M","False","r"
"3461","ECK1763-JW1754","ydjA",99,1842403,1842931,528,"50M","False","r"
"3463","ECK1764-JW1755","sppA",99,1843097,1844930,1833,"50M","False","f"
"3465","ECK1765-JW1756","ansA",99,1845120,1846113,993,"50M","False","f"
"3467","ECK1766-JW1757","pncA",99,1846147,1846765,618,"50M","False","f"
"3469","ECK1767-JW1758","ydjE",99,1846899,1848234,1335,"50M","False","r"
"3471","ECK1768-JW1759","ydjF",99,1848374,1849109,735,"50M","False","r"
"3473","ECK1769-JW1760","ydjG",99,1849269,1850226,957,"50M","False","r"
"3475","ECK1770-JW5289","ydjH",99,1850259,1851204,945,"50M","False","r"
"3477","ECK1771-JW1762","ydjI",99,1851211,1852024,813,"50M","False","r"
"3479","ECK1772-JW1763","ydjJ",99,1852068,1853088,1020,"50M","False","r"
"3481","ECK1773-JW5290","ydjK",99,1853128,1854484,1356,"50M","False","r"
"3483","ECK1774-JW1765","ydjL",99,1854534,1855587,1053,"50M","False","r"
"3485","ECK1775-JW1766","yeaC",99,1855980,1856229,249,"50M","False","r"
"3487","ECK1776-JW1767","yeaA",99,1856294,1856684,390,"50M","False","r"
"3489","ECK1777-JW1768","gapA",99,1857031,1858003,972,"50M","False","f"
"3491","ECK1778-JW1769","yeaD",99,1858110,1858971,861,"50M","False","f"
"3493","ECK1779-JW1770","yeaE",99,1859060,1859891,831,"50M","False","r"
"3495","ECK1780-JW1771","mipA",99,1860004,1860727,723,"50M","False","r"
"3497","ECK1781-JW1772","yeaG",99,1861168,1863079,1911,"50M","False","f"
"3499","ECK1782-JW1773","yeaH",99,1863215,1864475,1260,"50M","False","f"
"3501","ECK1783-JW1774","yeaI",99,1864645,1866097,1452,"50M","False","f"
"3503","ECK1784-JW5291","yeaJ",99,1866121,1867768,1647,"50M","False","f"
"3505","ECK1785-JW1776","yeaK",99,1867834,1868314,480,"50M","False","f"
"3507","ECK1787-JW1778","yeaL",99,1868612,1869035,423,"50M","False","f"
"3509","ECK1788-JW1779","yeaM",99,1869033,1869831,798,"50M","False","r"
"3511","ECK1789-JW1780","yeaN",99,1869933,1871091,1158,"50M","False","f"
"3513","ECK1790-JW1781","yeaO",99,1871169,1871493,324,"50M","False","f"
"3515","ECK1791-JW1782","yoaF",99,1871556,1871787,231,"50M","False","r"
"3517","ECK1792-JW5292","yeaP",99,1871975,1872977,1002,"50M","False","f"
"3519","ECK1793-JW1784","yeaQ",99,1873285,1873510,225,"50M","False","r"
"3521","ECK1794-JW1785","yoaG",99,1873681,1873840,159,"50M","False","r"
"3523","ECK1795-JW1786","yeaR",99,1873867,1874203,336,"50M","False","r"
"3525","ECK1796-JW1787","yeaS",99,1874399,1875014,615,"50M","False","r"
"3527","ECK1797-JW1788","yeaT",99,1875164,1876064,900,"50M","False","r"
"3529","ECK1798-JW1789","yeaU",99,1876172,1877234,1062,"50M","False","f"
"3531","ECK1799-JW5293","yeaV",99,1877448,1878870,1422,"50M","False","f"
"3533","ECK1800-JW5294","yeaW",99,1878925,1880026,1101,"50M","False","f"
"3535","ECK1801-JW1792","yeaX",99,1880105,1881047,942,"50M","False","f"
"3537","ECK1802-JW1793","rnd",99,1881142,1882246,1104,"50M","False","r"
"3539","ECK1803-JW1794","fadD",99,1882339,1884001,1662,"50M","False","r"
"3541","ECK1804-JW1795","yeaY",99,1884229,1884787,558,"50M","False","r"
"3543","ECK1805-JW1796","yeaZ",99,1884850,1885522,672,"50M","False","r"
"3545","ECK1806-JW1797","yoaA",99,1885603,1887490,1887,"50M","False","r"
"3547","ECK1807-JW5295","yoaB",99,1887624,1887948,324,"50M","False","f"
"3549","ECK1808-JW5296","yoaC",99,1888369,1888669,300,"50M","False","f"
"3551","ECK1809-JW1800","yoaH",99,1888830,1888986,156,"50M","False","r"
"3553","ECK1810-JW1801","pabB",99,1889065,1890403,1338,"50M","False","f"
"3555","ECK1811-JW1802","yeaB",99,1890430,1890985,555,"50M","False","f"
"3557","ECK1812-JW1803","sdaA",99,1891192,1892533,1341,"50M","False","f"
"3559","ECK1813-JW1804","yoaD",99,1892687,1894262,1575,"50M","False","f"
"3561","ECK1814-JW1805","yoaE",99,1894307,1895840,1533,"50M","False","r"
"3563","ECK1815-JW1806","manX",99,1896308,1897256,948,"50M","False","f"
"3565","ECK1816-JW1807","manY",99,1897342,1898119,777,"50M","False","f"
"3567","ECK1817-JW1808","manZ",99,1898146,1898983,837,"50M","False","f"
"3569","ECK1818-JW1809","yobD",99,1899061,1899496,435,"50M","False","f"
"3571","ECK1819-JW5830","yebN",99,1899894,1900491,597,"50M","False","f"
"3573","ECK1820-JW1811","rrmA",99,1900529,1901315,786,"50M","False","r"
"3575","ECK1821-JW1812","cspC",99,1901504,1901690,186,"50M","False","r"
"3577","ECK1822-JW1813","yobF",99,1901726,1901846,120,"50M","False","r"
"3579","ECK1823-JW1814","yebO",99,1902539,1902803,264,"50M","False","r"
"3581","ECK1824-JW1815","yobG",99,1902901,1903021,120,"50M","False","r"
"3583","ECK1825-JW5298","yobH",99,1903185,1903401,216,"50M","False","f"
"3585","ECK1826-JW1816","kdgR",99,1903586,1904354,768,"50M","False","r"
"3587","ECK1827-JW5299","yebQ",99,1904536,1905886,1350,"50M","False","f"
"3589","ECK1828-JW1818","htpX",99,1905973,1906831,858,"50M","False","r"
"3591","ECK1829-JW1819","prc",99,1907046,1909071,2025,"50M","False","r"
"3593","ECK1830-JW5300","proQ",99,1909114,1909789,675,"50M","False","r"
"3595","ECK1831-JW1821","yebR",99,1909909,1910437,528,"50M","False","r"
"3597","ECK1832-JW1822","yebS",99,1910518,1911778,1260,"50M","False","f"
"3599","ECK1833-JW1823","yebT",99,1911770,1914380,2610,"50M","False","f"
"3601","ECK1834-JW5301","yebU",99,1914477,1915899,1422,"50M","False","f"
"3603","ECK1835-JW5302","yebV",99,1916025,1916253,228,"50M","False","f"
"3605","ECK1836-JW5303","yebW",99,1916297,1916549,252,"50M","False","f"
"3607","ECK1837-JW1827","pphA",99,1916591,1917224,633,"50M","False","r"
"3609","ECK1840-JW1828","yebY",99,1917643,1917961,318,"50M","False","r"
"3611","ECK1841-JW1829","yebZ",99,1917997,1918846,849,"50M","False","r"
"3613","ECK1842-JW1830","yobA",99,1918873,1919224,351,"50M","False","r"
"3615","ECK1843-JW1831","holE",99,1919368,1919575,207,"50M","False","f"
"3617","ECK1844-JW1832","yobB",99,1919700,1920333,633,"50M","False","f"
"3619","ECK1845-JW1833","exoX",99,1920380,1921019,639,"50M","False","f"
"3621","ECK1846-JW1834","ptrB",99,1921057,1923094,2037,"50M","False","r"
"3623","ECK1847-JW1835","yebE",99,1923326,1923962,636,"50M","False","r"
"3625","ECK1848-JW1836","yebF",99,1924312,1924657,345,"50M","False","r"
"3627","ECK1849-JW1837","yebG",99,1924735,1925002,267,"50M","False","r"
"3629","ECK1850-JW1838","purT",99,1925141,1926296,1155,"50M","False","f"
"3631","ECK1851-JW1839","eda",99,1926393,1927011,618,"50M","False","r"
"3633","ECK1852-JW1840","edd",99,1927071,1928859,1788,"50M","False","r"
"3635","ECK1853-JW1841","zwf",99,1929117,1930569,1452,"50M","False","r"
"3637","ECK1854-JW1842","yebK",99,1930912,1931758,846,"50M","False","f"
"3639","ECK1855-JW1843","pykA",99,1931909,1933328,1419,"50M","False","f"
"3641","ECK1856-JW1844","lpxM",99,1933500,1934448,948,"50M","False","r"
"3643","ECK1857-JW5304","yebA",99,1934591,1935827,1236,"50M","False","r"
"3645","ECK1858-JW5831","znuA",99,1935929,1936892,963,"50M","False","r"
"3647","ECK1859-JW1847","znuC",99,1936922,1937654,732,"50M","False","f"
"3649","ECK1860-JW1848","znuB",99,1937674,1938436,762,"50M","False","f"
"3651","ECK1861-JW1849","ruvB",99,1938624,1939611,987,"50M","False","r"
"3653","ECK1862-JW1850","ruvA",99,1939643,1940231,588,"50M","False","r"
"3655","none-JW5305","none",99,1940237,1940321,84,"50M","False","f"
"3657","ECK1863-JW5306","yebB",99,1940412,1941090,678,"50M","False","f"
"3659","ECK1864-JW1852","ruvC",99,1941133,1941631,498,"50M","False","r"
"3661","ECK1865-JW1853","yebC",99,1941689,1942406,717,"50M","False","r"
"3663","ECK1866-JW1854","nudB",99,1942458,1942887,429,"50M","False","r"
"3665","ECK1867-JW1855","aspS",99,1943028,1944777,1749,"50M","False","r"
"3667","ECK1868-JW5307","yecD",99,1945059,1945635,576,"50M","False","f"
"3669","ECK1869-JW1857","yecE",99,1945655,1946450,795,"50M","False","f"
"3671","ECK1870-JW5308","yecN",99,1946367,1946898,531,"50M","False","f"
"3673","ECK1871-JW1859","yecO",99,1946962,1947682,720,"50M","False","f"
"3675","ECK1872-JW1860","yecP",99,1947702,1948650,948,"50M","False","f"
"3677","ECK1873-JW1861","torZ",99,1948856,1951262,2406,"50M","False","r"
"3679","ECK1874-JW1862","torY",99,1951310,1952387,1077,"50M","False","r"
"3681","ECK1875-JW1863","cutC",99,1952798,1953521,723,"50M","False","r"
"3683","ECK1876-JW5309","yecM",99,1953558,1953669,111,"50M","False","r"
"3685","ECK1877-JW1865","argS",99,1954322,1956032,1710,"50M","False","f"
"3687","ECK1878-JW5310","yecT",99,1956211,1956697,486,"50M","False","f"
"3689","ECK1879-JW1867","flhE",99,1956858,1957227,369,"50M","False","r"
"3691","ECK1880-JW1868","flhA",99,1957250,1959305,2055,"50M","False","r"
"3693","ECK1881-JW1869","flhB",99,1959321,1960446,1125,"50M","False","r"
"3695","ECK1882-JW1870","cheZ",99,1960671,1961292,621,"50M","False","r"
"3697","ECK1883-JW1871","cheY",99,1961326,1961692,366,"50M","False","r"
"3699","ECK1884-JW1872","cheB",99,1961730,1962756,1026,"50M","False","r"
"3701","ECK1885-JW1873","cheR",99,1962782,1963619,837,"50M","False","r"
"3703","ECK1886-JW1874","tap",99,1963661,1965239,1578,"50M","False","r"
"3705","ECK1887-JW1875","tar",99,1965308,1966946,1638,"50M","False","r"
"3707","ECK1888-JW1876","cheW",99,1967114,1967594,480,"50M","False","r"
"3709","ECK1889-JW1877","cheA",99,1967638,1969579,1941,"50M","False","r"
"3711","ECK1890-JW1878","motB",99,1969607,1970510,903,"50M","False","r"
"3713","ECK1891-JW1879","motA",99,1970530,1971394,864,"50M","False","r"
"3715","ECK1892-JW1880","flhC",99,1971544,1972099,555,"50M","False","r"
"3717","ECK1893-JW1881","flhD",99,1972125,1972461,336,"50M","False","r"
"3719","ECK1894-JW1884","yecG",99,1973237,1973642,405,"50M","False","f"
"3721","ECK1895-JW5312","otsA",99,1973690,1975097,1407,"50M","False","r"
"3723","ECK1896-JW1886","otsB",99,1975089,1975866,777,"50M","False","r"
"3725","ECK1897-JW1887","araH",99,1976056,1977022,966,"50M","False","r"
"3727","ECK1898-JW1888","araG",99,1977057,1978548,1491,"50M","False","r"
"3729","ECK1899-JW1889","araF",99,1978641,1979607,966,"50M","False","r"
"3731","ECK1900-JW1890","yecI",99,1980409,1980889,480,"50M","False","f"
"3733","ECK1901-JW1891","yecJ",99,1981009,1981237,228,"50M","False","r"
"3735","ECK1903-JW1892","yecR",99,1981706,1982006,300,"50M","False","f"
"3737","ECK1904-JW1893","ftn",99,1982200,1982674,474,"50M","False","f"
"3739","ECK1905-JW1894","yecH",99,1982753,1982969,216,"50M","False","r"
"3741","ECK1906-JW1895","tyrP",99,1983165,1984353,1188,"50M","False","f"
"3743","ECK1907-JW1896","yecA",99,1984456,1985098,642,"50M","False","r"
"3745","ECK1911-JW1897","pgsA",99,1985771,1986296,525,"50M","False","r"
"3747","ECK1912-JW1898","uvrC",99,1986376,1988185,1809,"50M","False","r"
"3749","ECK1913-JW1899","uvrY",99,1988205,1988838,633,"50M","False","r"
"3751","ECK1914-JW1900","yecF",99,1989302,1989503,201,"50M","False","f"
"3753","ECK1915-JW1901","sdiA",99,1989612,1990311,699,"50M","False","r"
"3755","ECK1916-JW1902","yecC",99,1990564,1991293,729,"50M","False","r"
"3757","ECK1917-JW1903","yecS",99,1991313,1991958,645,"50M","False","r"
"3759","ECK1918-JW5313","yedO",99,1991996,1992959,963,"50M","False","r"
"3761","ECK1919-JW1905","fliY",99,1993087,1993864,777,"50M","False","r"
"3763","ECK1920-JW1906","fliZ",99,1993975,1994503,528,"50M","False","r"
"3765","ECK1921-JW1907","fliA",99,1994575,1995268,693,"50M","False","r"
"3767","ECK1922-JW1908","fliC",99,1995612,1997085,1473,"50M","False","r"
"3769","ECK1923-JW1909","fliD",99,1997356,1998739,1383,"50M","False","f"
"3771","ECK1924-JW1910","fliS",99,1998787,1999174,387,"50M","False","f"
"3773","ECK1925-JW1911","fliT",99,1999197,1999539,342,"50M","False","f"
"3775","ECK1926-JW1912","amyA",99,1999640,2001104,1464,"50M","False","f"
"3777","ECK1927-JW1913","yedD",99,2001179,2001569,390,"50M","False","r"
"3779","ECK1928-JW1914","yedE",99,2001761,2002943,1182,"50M","False","f"
"3781","ECK1929-JW1915","yedF",99,2002963,2003173,210,"50M","False","f"
"3783","ECK1930-JW1916","yedK",99,2003305,2003950,645,"50M","False","f"
"3785","ECK1931-JW1917","yedL",99,2004084,2004540,456,"50M","False","f"
"3787","ECK1932-JW1918","yedN",99,2004850,2005018,168,"50M","False","r"
"3789","ECK1932-JW5912","yedN",99,2005051,2005348,297,"50M","False","r"
"3791","ECK1933-JW1920","yedM",99,2005503,2005830,327,"50M","False","r"
"3793","ECK1934-JW5913","intG",99,2006022,2006241,219,"50M","False","f"
"3795","ECK1935-JW1921","fliE",99,2006202,2006493,291,"50M","False","r"
"3797","ECK1936-JW1922","fliF",99,2006713,2008348,1635,"50M","False","f"
"3799","ECK1937-JW1923","fliG",99,2008364,2009336,972,"50M","False","f"
"3801","ECK1938-JW1924","fliH",99,2009352,2010015,663,"50M","False","f"
"3803","ECK1939-JW1925","fliI",99,2010038,2011388,1350,"50M","False","f"
"3805","ECK1940-JW1926","fliJ",99,2011430,2011850,420,"50M","False","f"
"3807","ECK1941-JW1927","fliK",99,2011870,2012974,1104,"50M","False","f"
"3809","ECK1942-JW1928","fliL",99,2013102,2013543,441,"50M","False","f"
"3811","ECK1943-JW1929","fliM",99,2013571,2014552,981,"50M","False","f"
"3813","ECK1944-JW1930","fliN",99,2014572,2014962,390,"50M","False","f"
"3815","ECK1945-JW5316","fliO",99,2014988,2015330,342,"50M","False","f"
"3817","ECK1946-JW1932","fliP",99,2015353,2016067,714,"50M","False","f"
"3819","ECK1947-JW1933","fliQ",99,2016100,2016346,246,"50M","False","f"
"3821","ECK1948-JW1934","fliR",99,2016377,2017139,762,"50M","False","f"
"3823","ECK1949-JW1935","rcsA",99,2017452,2018052,600,"50M","False","f"
"3825","ECK1950-JW1936","dsrB",99,2018137,2018302,165,"50M","False","r"
"3827","ECK1951-JW5317","yodD",99,2018467,2018674,207,"50M","False","f"
"3829","ECK1953-JW1938","yedP",99,2018995,2019787,792,"50M","False","f"
"3831","ECK1954-JW5832","yedQ",99,2019825,2021496,1671,"50M","False","r"
"3833","ECK1955-JW1940","yodC",99,2021690,2021849,159,"50M","False","r"
"3835","ECK1956-JW1941","yedI",99,2021951,2022845,894,"50M","False","r"
"3837","ECK1957-JW1942","yedA",99,2023023,2023920,897,"50M","False","f"
"3839","ECK1958-JW1943","vsr",99,2023950,2024397,447,"50M","False","r"
"3841","ECK1959-JW1944","dcm",99,2024401,2025796,1395,"50M","False","r"
"3843","ECK1960-JW1945","yedJ",99,2025886,2026558,672,"50M","False","r"
"3845","ECK1961-JW1946","yedR",99,2026621,2026963,342,"50M","False","r"
"3847","ECK1962-JW5319","yedS",99,2027535,2027997,462,"50M","False","f"
"3849","ECK1962-JW1948","yedS",99,2028030,2028216,186,"50M","False","f"
"3851","ECK1962-JW1949","yedS",99,2028323,2028704,381,"50M","False","f"
"3853","none-JW5320","none",99,2028746,2028890,144,"50M","False","r"
"3855","none-JW5321","none",99,2028954,2029167,213,"50M","False","r"
"3857","ECK1963-JW1950","hchA",99,2029319,2030147,828,"50M","False","f"
"3859","ECK1964-JW1951","yedV",99,2030296,2031631,1335,"50M","False","r"
"3861","ECK1965-JW5322","yedW",99,2031654,2032413,759,"50M","False","r"
"3863","ECK1966-JW1953","yedX",99,2032440,2032830,390,"50M","False","f"
"3865","ECK1967-JW1954","yedY",99,2032962,2033943,981,"50M","False","f"
"3867","ECK1968-JW1955","yedZ",99,2033967,2034579,612,"50M","False","f"
"3869","ECK1969-JW1956","yodA",99,2034859,2035486,627,"50M","False","f"
"3871","ECK1970-JW5323","yodB",99,2035828,2036359,531,"50M","False","f"
"3873","ECK1972-JW1958","yeeI",99,2037135,2037909,774,"50M","False","f"
"3875","ECK1974-JW5833","yeeJ",97,2038395,2045475,7080,"50M","False","f"
"3877","ECK1975-JW5325","yeeL",99,2045778,2046081,303,"50M","False","r"
"3879","ECK1975-JW1961","yeeL",99,2046126,2046807,681,"50M","False","r"
"3881","ECK1976-JW1962","shiA",99,2047127,2048420,1293,"50M","False","f"
"3883","ECK1977-JW1963","amn",99,2048545,2049976,1431,"50M","False","f"
"3885","ECK1978-JW1964","yeeN",99,2050342,2051035,693,"50M","False","f"
"3887","ECK1980-JW1965","yeeO",99,2051705,2053325,1620,"50M","False","r"
"3889","ECK1982-JW1966","cbl",99,2053466,2054393,927,"50M","False","r"
"3891","ECK1983-JW1967","nac",99,2054518,2055412,894,"50M","False","r"
"3893","ECK1985-JW1968","erfK",99,2055893,2056802,909,"50M","False","r"
"3895","ECK1986-JW1969","cobT",99,2056890,2057946,1056,"50M","False","r"
"3897","ECK1987-JW1970","cobS",99,2057981,2058701,720,"50M","False","r"
"3899","ECK1988-JW1971","cobU",99,2058721,2059243,522,"50M","False","r"
"3901","ECK1989-JW5326","yoeA",99,2062107,2062488,381,"50M","False","f"
"3903","ECK1990-JW1980","yoeE",99,2063728,2063965,237,"50M","False","f"
"3905","ECK1991-JW5327","yeeP",99,2064270,2064672,402,"50M","False","f"
"3907","ECK1993-JW1982","flu",99,2065023,2068118,3095,"50M","False","f"
"3909","ECK1994-JW1983","yeeR",99,2068263,2069772,1509,"50M","False","f"
"3911","ECK1995-JW1984","yeeS",99,2069792,2070215,423,"50M","False","f"
"3913","ECK1996-JW1985","yeeT",99,2070301,2070499,198,"50M","False","f"
"3915","ECK1997-JW1986","yeeU",99,2070596,2070941,345,"50M","False","f"
"3917","ECK1998-JW1987","yeeV",99,2071053,2071404,351,"50M","False","f"
"3919","ECK1999-JW1988","yeeW",99,2071424,2071595,171,"50M","False","f"
"3921","ECK2000-JW5328","yoeF",99,2072059,2072392,333,"50M","False","f"
"3923","ECK2001-JW1989","yeeX",99,2072534,2072906,372,"50M","False","r"
"3925","ECK2002-JW1990","yeeA",99,2073035,2074070,1035,"50M","False","r"
"3927","ECK2003-JW1991","sbmC",99,2074291,2074741,450,"50M","False","r"
"3929","ECK2004-JW5329","dacD",99,2074883,2076032,1149,"50M","False","r"
"3931","ECK2005-JW1993","sbcB",99,2076240,2077644,1404,"50M","False","f"
"3933","ECK2006-JW1994","yeeD",99,2077728,2077932,204,"50M","False","r"
"3935","ECK2007-JW1995","yeeE",99,2077969,2079004,1035,"50M","False","r"
"3937","ECK2008-JW5330","yeeF",99,2079206,2080541,1335,"50M","False","r"
"3939","ECK2009-JW5834","yeeY",99,2080831,2081758,927,"50M","False","r"
"3941","ECK2010-JW1998","yeeZ",99,2081806,2082607,801,"50M","False","r"
"3943","ECK2011-JW5331","yoeB",99,2082713,2082944,231,"50M","False","r"
"3945","ECK2012-JW5835","yefM",99,2082964,2083192,228,"50M","False","r"
"3947","ECK2013-JW2000","hisL",99,2083480,2083507,27,"50M","False","f"
"3949","ECK2014-JW2001","hisG",99,2083676,2084552,876,"50M","False","f"
"3951","ECK2015-JW2002","hisD",99,2084581,2085862,1281,"50M","False","f"
"3953","ECK2016-JW2003","hisC",99,2085882,2086929,1047,"50M","False","f"
"3955","ECK2017-JW2004","hisB",99,2086952,2087996,1044,"50M","False","f"
"3957","ECK2018-JW2005","hisH",99,2088019,2088586,567,"50M","False","f"
"3959","ECK2019-JW2006","hisA",99,2088609,2089323,714,"50M","False","f"
"3961","ECK2020-JW2007","hisF",99,2089328,2090081,753,"50M","False","f"
"3963","ECK2021-JW2008","hisI",99,2090098,2090686,588,"50M","False","f"
"3965","ECK2022-JW5836","cld",99,2090823,2091783,960,"50M","False","r"
"3967","ECK2023-JW2010","ugd",99,2091949,2093092,1143,"50M","False","r"
"3969","ECK2024-JW2011","gnd",99,2093364,2094747,1383,"50M","False","r"
"3971","ECK2025-JW2012","wbbL",99,2094898,2095156,258,"50M","False","r"
"3973","ECK2025-JW2016","wbbL",99,2096418,2096868,450,"50M","False","r"
"3975","ECK2026-JW2017","wbbK",99,2096893,2097988,1095,"50M","False","r"
"3977","ECK2027-JW2018","wbbJ",99,2097996,2098563,567,"50M","False","r"
"3979","ECK2028-JW2019","wbbI",99,2098567,2099536,969,"50M","False","r"
"3981","ECK2029-JW2020","wbbH",99,2099562,2100705,1143,"50M","False","r"
"3983","ECK2030-JW2021","glf",99,2100728,2101808,1080,"50M","False","r"
"3985","ECK2031-JW2022","rfbX",99,2101839,2103063,1224,"50M","False","r"
"3987","ECK2032-JW2023","rfbC",99,2103083,2103617,534,"50M","False","r"
"3989","ECK2033-JW2024","rfbA",99,2103640,2104498,858,"50M","False","r"
"3991","ECK2034-JW2025","rfbD",99,2104579,2105455,876,"50M","False","r"
"3993","ECK2035-JW2026","rfbB",99,2105478,2106540,1062,"50M","False","r"
"3995","ECK2036-JW2027","galF",99,2106936,2107806,870,"50M","False","r"
"3997","ECK2037-JW2028","wcaM",99,2108004,2109375,1371,"50M","False","r"
"3999","ECK2038-JW2029","wcaL",99,2109409,2110606,1197,"50M","False","r"
"4001","ECK2039-JW2030","wcaK",99,2110626,2111883,1257,"50M","False","r"
"4003","ECK2040-JW2031","wzxC",99,2112182,2113637,1455,"50M","False","r"
"4005","ECK2041-JW2032","wcaJ",99,2113662,2115033,1371,"50M","False","r"
"4007","ECK2042-JW2033","cpsG",99,2115111,2116458,1347,"50M","False","r"
"4009","ECK2043-JW2034","cpsB",99,2116586,2117999,1413,"50M","False","r"
"4011","ECK2044-JW2035","wcaI",99,2118025,2119225,1200,"50M","False","r"
"4013","ECK2045-JW5335","nudD",99,2119245,2119704,459,"50M","False","r"
"4015","ECK2046-JW2037","fcl",99,2119727,2120669,942,"50M","False","r"
"4017","ECK2047-JW2038","gmd",99,2120695,2121793,1098,"50M","False","r"
"4019","ECK2048-JW2039","wcaF",99,2121842,2122367,525,"50M","False","r"
"4021","ECK2049-JW2040","wcaE",99,2122406,2123129,723,"50M","False","r"
"4023","ECK2050-JW2041","wcaD",99,2123163,2124357,1194,"50M","False","r"
"4025","ECK2051-JW2042","wcaC",99,2124355,2125549,1194,"50M","False","r"
"4027","ECK2052-JW2043","wcaB",99,2125569,2126034,465,"50M","False","r"
"4029","ECK2053-JW2044","wcaA",99,2126060,2126876,816,"50M","False","r"
"4031","ECK2054-JW2045","wzc",99,2126992,2129131,2139,"50M","False","r"
"4033","ECK2055-JW2046","wzb",99,2129157,2129577,420,"50M","False","r"
"4035","ECK2056-JW2047","wza",99,2129606,2130722,1116,"50M","False","r"
"4037","ECK2057-JW5336","yegH",99,2131347,2132946,1599,"50M","False","f"
"4039","ECK2058-JW2049","asmA",99,2133261,2135091,1830,"50M","False","r"
"4041","ECK2059-JW2050","dcd",99,2135136,2135694,558,"50M","False","r"
"4043","ECK2060-JW2051","udk",99,2135809,2136427,618,"50M","False","r"
"4045","ECK2061-JW2052","yegE",99,2136750,2140044,3294,"50M","False","f"
"4047","ECK2062-JW2053","alkA",99,2140194,2141019,825,"50M","False","r"
"4049","ECK2063-JW2054","yegD",99,2141158,2142487,1329,"50M","False","f"
"4051","ECK2064-JW2055","yegI",99,2142541,2144464,1923,"50M","False","r"
"4053","ECK2065-JW2056","yegJ",99,2144669,2145107,438,"50M","False","f"
"4055","ECK2066-JW2057","yegK",99,2145213,2145951,738,"50M","False","r"
"4057","ECK2067-JW2058","yegL",99,2145971,2146607,636,"50M","False","r"
"4059","none-JW5337","none",99,2147184,2147307,123,"50M","False","f"
"4061","ECK2070-JW5338","mdtA",99,2147380,2148724,1344,"50M","False","f"
"4063","ECK2071-JW2060","mdtB",99,2148747,2151846,3099,"50M","False","f"
"4065","ECK2072-JW2061","mdtC",99,2151870,2154924,3054,"50M","False","f"
"4067","ECK2073-JW2062","mdtD",99,2154948,2156340,1392,"50M","False","f"
"4069","ECK2074-JW2063","baeS",99,2156360,2157740,1380,"50M","False","f"
"4071","ECK2075-JW2064","baeR",99,2157760,2158459,699,"50M","False","f"
"4073","ECK2076-JW5339","yegP",99,2158634,2158982,348,"50M","False","f"
"4075","ECK2077-JW2066","yegQ",99,2159152,2160490,1338,"50M","False","f"
"4077","ECK2079-JW2067","ogrK",99,2160804,2160999,195,"50M","False","r"
"4079","ECK2081-JW5837","yegR",99,2161491,2161845,354,"50M","False","r"
"4081","ECK2082-JW2070","yegS",99,2162196,2163072,876,"50M","False","f"
"4083","ECK2083-JW5340","gatR",99,2163195,2163645,450,"50M","False","r"
"4085","ECK2083-JW2074","gatR",99,2164897,2165212,315,"50M","False","r"
"4087","ECK2084-JW2075","gatD",99,2165335,2166352,1017,"50M","False","r"
"4089","ECK2085-JW2076","gatC",99,2166423,2167755,1332,"50M","False","r"
"4091","ECK2086-JW2077","gatB",99,2167782,2168043,261,"50M","False","r"
"4097","ECK2088-JW2082","gatZ",99,2168559,2169798,1239,"50M","False","r"
"4099","ECK2089-JW5343","gatY",99,2169850,2170681,831,"50M","False","r"
"4101","ECK2090-JW5344","fbaB",99,2171012,2172113,1101,"50M","False","r"
"4103","ECK2091-JW2085","yegT",99,2172303,2173557,1254,"50M","False","f"
"4105","ECK2092-JW2086","yegU",99,2173577,2174558,981,"50M","False","f"
"4107","ECK2093-JW2087","yegV",99,2174578,2175520,942,"50M","False","f"
"4109","ECK2094-JW2088","yegW",99,2175535,2176258,723,"50M","False","r"
"4111","ECK2095-JW5345","yegX",99,2176333,2177137,804,"50M","False","r"
"4113","ECK2096-JW2090","thiD",99,2177216,2177993,777,"50M","False","r"
"4115","ECK2097-JW2091","thiM",99,2178013,2178778,765,"50M","False","r"
"4117","ECK2098-JW2092","yohL",99,2179024,2179273,249,"50M","False","r"
"4119","ECK2099-JW2093","yohM",99,2179399,2180200,801,"50M","False","f"
"4121","ECK2100-JW5346","yohN",99,2180262,2180757,495,"50M","False","f"
"4123","ECK2101-JW2095","yehA",99,2180880,2181891,1011,"50M","False","r"
"4125","ECK2102-JW2096","yehB",99,2181930,2184387,2457,"50M","False","r"
"4127","ECK2103-JW2097","yehC",99,2184426,2185122,696,"50M","False","r"
"4129","ECK2104-JW2098","yehD",99,2185180,2185699,519,"50M","False","r"
"4131","ECK2105-JW2099","yehE",99,2186015,2186273,258,"50M","False","r"
"4133","ECK2106-JW2100","mrp",99,2186559,2187645,1086,"50M","False","r"
"4135","ECK2107-JW2101","metG",99,2187782,2189792,2010,"50M","False","f"
"4137","ECK2108-JW2102","molR",99,2189956,2190757,801,"50M","False","f"
"4139","ECK2108-JW5915","molR",99,2190985,2192806,1821,"50M","False","f"
"4141","ECK2108-JW5916","molR",99,2193059,2193728,669,"50M","False","f"
"4143","ECK2109-JW2105","yehI",97,2193761,2197370,3609,"50M","False","f"
"4145","ECK2110-JW2106","yehK",99,2197454,2197748,294,"50M","False","f"
"4147","ECK2111-JW5349","yehL",99,2198012,2199143,1131,"50M","False","f"
"4149","ECK2112-JW2108","yehM",99,2199177,2201433,2256,"50M","False","f"
"4151","ECK2113-JW5350","yehP",99,2201221,2202562,1341,"50M","False","f"
"4153","ECK2114-JW2110","yehQ",99,2202582,2204403,1821,"50M","False","f"
"4155","ECK2115-JW5351","yehR",99,2204695,2205145,450,"50M","False","f"
"4157","ECK2116-JW2112","yehS",99,2205226,2205673,447,"50M","False","r"
"4159","ECK2117-JW5352","yehT",99,2205743,2206454,711,"50M","False","r"
"4161","ECK2118-JW5353","yehU",99,2206459,2208136,1677,"50M","False","r"
"4163","ECK2119-JW2115","mlrA",99,2208348,2209056,708,"50M","False","f"
"4165","ECK2120-JW5354","yohO",99,2209139,2209223,84,"50M","False","f"
"4167","ECK2121-JW2116","yehW",99,2209245,2209953,708,"50M","False","r"
"4169","ECK2122-JW2117","yehX",99,2209981,2210884,903,"50M","False","r"
"4171","ECK2123-JW2118","yehY",99,2210900,2212034,1134,"50M","False","r"
"4173","ECK2124-JW2119","yehZ",99,2212064,2212958,894,"50M","False","r"
"4175","ECK2125-JW2120","bglX",99,2213192,2215466,2274,"50M","False","r"
"4177","ECK2126-JW2121","dld",99,2215667,2217359,1692,"50M","False","f"
"4179","ECK2127-JW5355","pbpG",99,2217438,2218347,909,"50M","False","r"
"4181","ECK2128-JW5356","yohC",99,2218544,2219132,588,"50M","False","r"
"4183","ECK2129-JW2124","yohD",99,2219283,2219838,555,"50M","False","f"
"4185","none-JW5357","none",99,2219870,2219972,102,"50M","False","r"
"4187","ECK2130-JW2125","yohF",99,2220009,2220747,738,"50M","False","r"
"4189","ECK2131-JW5838","yohG",99,2220823,2221996,1173,"50M","False","r"
"4191","ECK2132-JW5358","yohH",99,2222049,2222316,267,"50M","False","r"
"4193","ECK2133-JW2128","dusC",99,2222938,2223862,924,"50M","False","r"
"4195","ECK2134-JW2129","yohJ",99,2224106,2224481,375,"50M","False","f"
"4197","ECK2135-JW2130","yohK",99,2224501,2225173,672,"50M","False","f"
"4199","ECK2136-JW2131","cdd",99,2225326,2226187,861,"50M","False","f"
"4201","ECK2137-JW2132","sanA",99,2226360,2227056,696,"50M","False","f"
"4203","ECK2138-JW5359","yeiS",99,2227082,2227298,216,"50M","False","f"
"4205","ECK2139-JW2133","yeiT",99,2227515,2228730,1215,"50M","False","f"
"4207","ECK2140-JW2134","yeiA",99,2228747,2229959,1212,"50M","False","f"
"4209","ECK2141-JW2135","mglC",99,2230243,2231230,987,"50M","False","r"
"4211","ECK2142-JW2136","mglA",99,2231269,2232766,1497,"50M","False","r"
"4213","ECK2143-JW2137","mglB",99,2232850,2233825,975,"50M","False","r"
"4215","ECK2144-JW2138","galS",99,2234128,2235145,1017,"50M","False","r"
"4217","ECK2145-JW2139","yeiB",99,2235310,2236444,1134,"50M","False","r"
"4219","none-JW5360","none",99,2236480,2236561,81,"50M","False","r"
"4221","ECK2146-JW2140","folE",99,2236484,2237129,645,"50M","False","r"
"4223","ECK2147-JW2141","yeiG",99,2237392,2238205,813,"50M","False","f"
"4225","ECK2148-JW2142","cirA",99,2238278,2240246,1968,"50M","False","r"
"4227","ECK2149-JW2143","lysP",99,2240563,2242009,1446,"50M","False","r"
"4229","ECK2150-JW2144","yeiE",99,2242237,2243095,858,"50M","False","r"
"4231","ECK2151-JW2145","yeiH",99,2243199,2244225,1026,"50M","False","f"
"4233","ECK2152-JW2146","nfo",99,2244322,2245156,834,"50M","False","f"
"4235","ECK2153-JW2147","yeiI",99,2245182,2246247,1065,"50M","False","f"
"4237","ECK2154-JW2148","yeiJ",99,2246395,2247622,1227,"50M","False","r"
"4239","ECK2155-JW2149","rihB",99,2247745,2248663,918,"50M","False","r"
"4241","ECK2156-JW2150","yeiL",99,2248837,2249473,636,"50M","False","f"
"4243","ECK2157-JW2151","yeiM",99,2249585,2250812,1227,"50M","False","r"
"4245","ECK2158-JW2152","yeiN",99,2250929,2251844,915,"50M","False","r"
"4247","ECK2159-JW2153","yeiC",99,2251855,2252773,918,"50M","False","r"
"4249","ECK2160-JW2154","fruA",99,2253219,2254887,1668,"50M","False","r"
"4251","ECK2161-JW2155","fruK",99,2254927,2255842,915,"50M","False","r"
"4253","ECK2162-JW2156","fruB",99,2255865,2256972,1107,"50M","False","r"
"4255","ECK2163-JW2157","setB",99,2257345,2258503,1158,"50M","False","f"
"4257","ECK2164-JW5361","yeiW",99,2258541,2258904,363,"50M","False","r"
"4259","ECK2165-JW5362","yeiP",99,2258932,2259481,549,"50M","False","f"
"4261","ECK2166-JW2160","yeiQ",99,2259727,2261170,1443,"50M","False","f"
"4263","ECK2167-JW2161","yeiR",99,2261311,2262274,963,"50M","False","f"
"4265","ECK2168-JW2162","yeiU",99,2262336,2263026,690,"50M","False","f"
"4267","ECK2169-JW2163","spr",99,2263461,2264004,543,"50M","False","f"
"4269","ECK2170-JW2164","rtn",99,2264208,2265741,1533,"50M","False","f"
"4271","ECK2171-JW2165","yejA",99,2265846,2267637,1791,"50M","False","f"
"4273","ECK2172-JW2166","yejB",99,2267661,2268732,1071,"50M","False","f"
"4275","ECK2173-JW2167","yejE",99,2268755,2269757,1002,"50M","False","f"
"4277","ECK2174-JW2168","yejF",99,2269782,2271348,1566,"50M","False","f"
"4279","ECK2175-JW2169","yejG",99,2271393,2271714,321,"50M","False","r"
"4281","ECK2176-JW5363","bcr",99,2272070,2273237,1167,"50M","False","r"
"4283","ECK2177-JW2171","rsuA",99,2273288,2273960,672,"50M","False","r"
"4285","ECK2178-JW2172","yejH",99,2274114,2275851,1737,"50M","False","f"
"4287","ECK2179-JW2173","rplY",99,2275999,2276260,261,"50M","False","f"
"4289","ECK2180-JW2174","yejK",99,2276440,2277424,984,"50M","False","r"
"4291","ECK2181-JW2175","yejL",99,2277611,2277815,204,"50M","False","f"
"4293","ECK2182-JW2176","yejM",99,2277858,2279595,1737,"50M","False","f"
"4295","ECK2184-JW5839","yejO",99,2279890,2282089,2199,"50M","False","r"
"4297","ECK2185-JW2181","narP",99,2283982,2284606,624,"50M","False","f"
"4299","ECK2186-JW2182","ccmH",99,2284858,2285887,1029,"50M","False","r"
"4301","ECK2187-JW2183","ccmG",99,2285907,2286441,534,"50M","False","r"
"4303","ECK2188-JW2184","ccmF",99,2286461,2288381,1920,"50M","False","r"
"4305","ECK2189-JW2185","ccmE",99,2288401,2288857,456,"50M","False","r"
"4307","ECK2190-JW2186","ccmD",99,2288877,2289063,186,"50M","False","r"
"4309","ECK2191-JW2187","ccmC",99,2289083,2289797,714,"50M","False","r"
"4311","ECK2192-JW2188","ccmB",99,2289862,2290501,639,"50M","False","r"
"4313","ECK2193-JW5366","ccmA",99,2290521,2291121,600,"50M","False","r"
"4315","ECK2194-JW2190","napC",99,2291157,2291736,579,"50M","False","r"
"4317","ECK2195-JW5367","napB",99,2291769,2292195,426,"50M","False","r"
"4319","ECK2196-JW2192","napH",99,2292215,2293055,840,"50M","False","r"
"4321","ECK2197-JW2193","napG",99,2293065,2293737,672,"50M","False","r"
"4323","ECK2198-JW2194","napA",99,2293767,2296230,2463,"50M","False","r"
"4325","ECK2199-JW2195","napD",99,2296250,2296490,240,"50M","False","r"
"4327","ECK2200-JW2196","napF",99,2296503,2296974,471,"50M","False","r"
"4329","ECK2201-JW2197","eco",99,2297387,2297852,465,"50M","False","f"
"4331","ECK2202-JW2198","mqo",99,2298608,2300231,1623,"50M","False","r"
"4333","ECK2203-JW2199","yojI",99,2300472,2302092,1620,"50M","False","r"
"4335","ECK2204-JW2200","alkB",99,2302191,2302818,627,"50M","False","r"
"4337","ECK2205-JW2201","ada",99,2302841,2303882,1041,"50M","False","r"
"4339","ECK2206-JW5368","yojL",99,2303979,2305011,1032,"50M","False","r"
"4341","ECK2207-JW2203","ompC",99,2305146,2306226,1080,"50M","False","r"
"4343","ECK2209-JW2204","rcsD",99,2306970,2309619,2649,"50M","False","f"
"4345","ECK2210-JW2205","rcsB",99,2309659,2310286,627,"50M","False","f"
"4347","ECK2211-JW5917","rcsC",99,2310527,2310881,354,"50M","False","r"
"4353","ECK2212-JW2213","atoS",99,2313525,2315328,1803,"50M","False","f"
"4355","ECK2213-JW2214","atoC",99,2315348,2316710,1362,"50M","False","f"
"4357","ECK2214-JW2215","atoD",99,2316929,2317568,639,"50M","False","f"
"4359","ECK2215-JW2216","atoA",99,2317591,2318218,627,"50M","False","f"
"4361","ECK2216-JW2217","atoE",99,2318238,2319537,1299,"50M","False","f"
"4363","ECK2217-JW2218","atoB",99,2319591,2320752,1161,"50M","False","f"
"4365","ECK2218-JW2219","yfaP",99,2320867,2321620,753,"50M","False","r"
"4367","ECK2219-JW2220","yfaQ",99,2321648,2323274,1626,"50M","False","r"
"4369","ECK2220-JW2221","yfaS",99,2323298,2323760,462,"50M","False","r"
"4371","ECK2220-JW2222","yfaS",97,2323799,2327879,4080,"50M","False","r"
"4373","ECK2221-JW2223","yfaT",99,2327836,2328436,600,"50M","False","r"
"4375","ECK2222-JW2224","yfaA",99,2328456,2330121,1665,"50M","False","r"
"4377","ECK2223-JW2225","gyrA",99,2330293,2332897,2604,"50M","False","r"
"4379","ECK2224-JW2226","ubiG",99,2333049,2333748,699,"50M","False","f"
"4381","ECK2225-JW2227","yfaL",97,2333917,2337646,3729,"50M","False","r"
"4383","ECK2226-JW2228","nrdA",99,2338347,2340609,2262,"50M","False","f"
"4385","ECK2227-JW2229","nrdB",99,2340866,2341973,1107,"50M","False","f"
"4387","ECK2228-JW2230","yfaE",99,2341996,2342227,231,"50M","False","f"
"4389","ECK2229-JW2231","inaA",99,2342322,2342949,627,"50M","False","r"
"4391","ECK2230-JW2232","yfaH",99,2343169,2343352,183,"50M","False","f"
"4393","ECK2231-JW2233","glpQ",99,2343435,2344488,1053,"50M","False","r"
"4395","ECK2232-JW2234","glpT",99,2344516,2345851,1335,"50M","False","r"
"4397","ECK2233-JW2235","glpA",99,2346129,2347734,1605,"50M","False","f"
"4399","ECK2234-JW2236","glpB",99,2347747,2348983,1236,"50M","False","f"
"4401","ECK2235-JW2237","glpC",99,2349003,2350170,1167,"50M","False","f"
"4403","ECK2236-JW2238","yfaD",99,2350386,2351262,876,"50M","False","f"
"4405","ECK2237-JW5964","ypaA",99,2351298,2351460,162,"50M","False","f"
"4407","ECK2238-JW2239","yfaU",99,2351542,2352322,780,"50M","False","r"
"4409","ECK2239-JW2240","yfaV",99,2352363,2353629,1266,"50M","False","r"
"4411","ECK2240-JW2241","yfaW",99,2353709,2354903,1194,"50M","False","r"
"4413","ECK2241-JW2242","yfaX",99,2354929,2355688,759,"50M","False","r"
"4415","ECK2242-JW2243","yfaY",99,2355931,2357110,1179,"50M","False","r"
"4417","ECK2243-JW5371","yfaZ",99,2357233,2357719,486,"50M","False","r"
"4419","ECK2244-JW2245","yfaO",99,2358036,2358438,402,"50M","False","f"
"4421","ECK2245-JW2246","ais",99,2358518,2359097,579,"50M","False","r"
"4423","ECK2246-JW5372","yfbE",99,2359377,2360526,1149,"50M","False","f"
"4425","ECK2247-JW2248","yfbF",99,2360553,2361498,945,"50M","False","f"
"4427","ECK2248-JW2249","yfbG",99,2361521,2363480,1959,"50M","False","f"
"4429","ECK2249-JW2250","yfbH",99,2363500,2364367,867,"50M","False","f"
"4431","ECK2250-JW2251","arnT",99,2364390,2366019,1629,"50M","False","f"
"4433","ECK2251-JW2252","yfbW",99,2366039,2366351,312,"50M","False","f"
"4435","ECK2252-JW5373","yfbJ",99,2366092,2366737,645,"50M","False","f"
"4437","ECK2253-JW2254","pmrD",99,2366772,2367015,243,"50M","False","r"
"4439","ECK2254-JW2255","menE",99,2367148,2368480,1332,"50M","False","r"
"4441","ECK2255-JW2256","menC",99,2368500,2369439,939,"50M","False","r"
"4443","ECK2256-JW2257","menB",99,2369462,2370296,834,"50M","False","r"
"4445","ECK2257-JW2258","yfbB",99,2370334,2371069,735,"50M","False","r"
"4447","ECK2258-JW5374","menD",99,2371089,2372736,1647,"50M","False","r"
"4449","ECK2259-JW2260","menF",99,2372848,2374120,1272,"50M","False","r"
"4451","ECK2260-JW2261","elaB",99,2374222,2374504,282,"50M","False","r"
"4453","ECK2261-JW2262","elaA",99,2374582,2375020,438,"50M","False","r"
"4455","ECK2262-JW2263","elaC",99,2375090,2375984,894,"50M","False","f"
"4457","ECK2263-JW5840","elaD",99,2376195,2377383,1188,"50M","False","f"
"4459","ECK2264-JW2265","yfbK",99,2377495,2379199,1704,"50M","False","r"
"4461","ECK2265-JW2266","yfbL",99,2379342,2380290,948,"50M","False","f"
"4463","ECK2266-JW2267","yfbM",99,2380416,2380896,480,"50M","False","f"
"4465","ECK2267-JW2268","yfbN",99,2381210,2381903,693,"50M","False","r"
"4467","ECK2268-JW2269","yfbO",99,2382063,2382516,453,"50M","False","f"
"4469","ECK2269-JW2270","yfbP",99,2382595,2383423,828,"50M","False","f"
"4471","ECK2270-JW2271","nuoN",99,2383548,2384802,1254,"50M","False","r"
"4473","ECK2271-JW2272","nuoM",99,2385012,2386518,1506,"50M","False","r"
"4475","ECK2272-JW2273","nuoL",99,2386705,2388523,1818,"50M","False","r"
"4477","ECK2273-JW2274","nuoK",99,2388543,2388822,279,"50M","False","r"
"4479","ECK2274-JW2275","nuoJ",99,2388842,2389373,531,"50M","False","r"
"4481","ECK2275-JW2276","nuoI",99,2389408,2389927,519,"50M","False","r"
"4483","ECK2276-JW2277","nuoH",99,2389965,2390919,954,"50M","False","r"
"4485","ECK2277-JW2278","nuoG",99,2390939,2393648,2709,"50M","False","r"
"4487","ECK2278-JW2279","nuoF",99,2393718,2395032,1314,"50M","False","r"
"4489","ECK2279-JW2280","nuoE",99,2395052,2395529,477,"50M","False","r"
"4491","ECK2280-JW5375","nuoC",99,2395555,2397334,1779,"50M","False","r"
"4493","ECK2281-JW5875","nuoB",99,2397451,2398090,639,"50M","False","r"
"4495","ECK2282-JW2283","nuoA",99,2398129,2398549,420,"50M","False","r"
"4497","ECK2283-JW2284","lrhA",99,2399203,2400118,915,"50M","False","r"
"4499","ECK2284-JW2287","yfbQ",99,2401043,2402237,1194,"50M","False","f"
"4501","ECK2285-JW2288","yfbR",99,2402344,2402920,576,"50M","False","f"
"4503","ECK2286-JW2289","yfbS",99,2403020,2404829,1809,"50M","False","r"
"4505","ECK2287-JW5376","yfbT",99,2404939,2405584,645,"50M","False","r"
"4507","ECK2288-JW2291","yfbU",99,2405600,2406071,471,"50M","False","r"
"4509","ECK2289-JW2292","yfbV",99,2406177,2406609,432,"50M","False","r"
"4511","ECK2290-JW2293","ackA",99,2406952,2408131,1179,"50M","False","f"
"4513","ECK2291-JW2294","pta",99,2408229,2410350,2121,"50M","False","f"
"4515","ECK2292-JW2295","yfcC",99,2410563,2412060,1497,"50M","False","f"
"4517","ECK2293-JW2296","yfcD",99,2412134,2412653,519,"50M","False","r"
"4519","ECK2294-JW5377","yfcE",99,2412734,2413262,528,"50M","False","r"
"4521","ECK2295-JW2298","yfcF",99,2413341,2413962,621,"50M","False","r"
"4523","ECK2296-JW2299","yfcG",99,2414103,2414727,624,"50M","False","f"
"4525","ECK2297-JW2300","folX",99,2414807,2415146,339,"50M","False","f"
"4527","ECK2298-JW2301","yfcH",99,2415190,2416060,870,"50M","False","f"
"4529","ECK2299-JW2302","yfcI",99,2416149,2417016,867,"50M","False","r"
"4531","ECK2300-JW2303","hisP",99,2417236,2417986,750,"50M","False","r"
"4533","ECK2301-JW2304","hisM",99,2418017,2418710,693,"50M","False","r"
"4535","ECK2302-JW2305","hisQ",99,2418730,2419393,663,"50M","False","r"
"4537","ECK2303-JW2306","hisJ",99,2419506,2420265,759,"50M","False","r"
"4539","ECK2304-JW2307","argT",99,2420509,2421268,759,"50M","False","r"
"4541","ECK2305-JW2308","ubiX",99,2421557,2422103,546,"50M","False","r"
"4543","ECK2306-JW2309","purF",99,2422221,2423715,1494,"50M","False","r"
"4545","ECK2307-JW2310","cvpA",99,2423775,2424240,465,"50M","False","r"
"4547","ECK2308-JW5378","dedD",99,2424522,2425134,612,"50M","False","r"
"4549","ECK2309-JW2312","folC",99,2425174,2426419,1245,"50M","False","r"
"4551","ECK2310-JW2313","accD",99,2426512,2427403,891,"50M","False","r"
"4553","none-JW5379","none",99,2427413,2427500,87,"50M","False","r"
"4555","ECK2311-JW2314","dedA",99,2427582,2428218,636,"50M","False","r"
"4557","ECK2312-JW2315","truA",99,2428324,2429113,789,"50M","False","r"
"4559","ECK2313-JW2316","usg",99,2429136,2430126,990,"50M","False","r"
"4561","ECK2314-JW2317","pdxB",99,2430215,2431328,1113,"50M","False","r"
"4563","ECK2315-JW2318","flk",99,2431432,2432404,972,"50M","False","f"
"4565","ECK2316-JW2319","yfcJ",99,2432442,2433597,1155,"50M","False","r"
"4567","ECK2317-JW2320","fabB",99,2433885,2435082,1197,"50M","False","r"
"4569","ECK2318-JW5380","trmC",99,2435186,2437229,2043,"50M","False","f"
"4571","ECK2319-JW2322","yfcL",99,2437391,2437646,255,"50M","False","r"
"4573","ECK2320-JW5381","yfcM",99,2437703,2438414,711,"50M","False","r"
"4575","ECK2321-JW2324","yfcA",99,2438251,2439037,786,"50M","False","r"
"4577","ECK2322-JW2325","mepA",99,2439060,2439861,801,"50M","False","r"
"4579","ECK2323-JW2326","aroC",99,2439888,2440950,1062,"50M","False","r"
"4581","ECK2324-JW5841","prmB",99,2441008,2442250,1242,"50M","False","r"
"4583","ECK2325-JW2328","yfcN",99,2442088,2442616,528,"50M","False","f"
"4585","ECK2326-JW2329","yfcO",99,2442728,2443526,798,"50M","False","r"
"4587","ECK2327-JW2330","yfcP",99,2443551,2444067,516,"50M","False","r"
"4589","ECK2328-JW2331","yfcQ",99,2444087,2444552,465,"50M","False","r"
"4591","ECK2329-JW2332","yfcR",99,2444572,2445061,489,"50M","False","r"
"4593","ECK2330-JW2333","yfcS",99,2445084,2445813,729,"50M","False","r"
"4595","ECK2331-JW2334","yfcT",99,2445856,2446729,873,"50M","False","r"
"4597","ECK2332-JW2335","yfcU",99,2446765,2448478,1713,"50M","False","r"
"4599","ECK2333-JW2336","yfcV",99,2448583,2449123,540,"50M","False","r"
"4601","ECK2334-JW2337","sixA",99,2449827,2450289,462,"50M","False","r"
"4603","ECK2335-JW2338","yfcX",99,2450515,2452636,2121,"50M","False","r"
"4605","ECK2336-JW2339","yfcY",99,2452659,2453946,1287,"50M","False","r"
"4607","ECK2337-JW2340","yfcZ",99,2454150,2454411,261,"50M","False","r"
"4609","ECK2338-JW2341","fadL",99,2454782,2456105,1323,"50M","False","f"
"4611","ECK2339-JW2342","yfdF",99,2456494,2457529,1035,"50M","False","f"
"4613","ECK2340-JW2343","vacJ",99,2457752,2458484,732,"50M","False","r"
"4615","ECK2341-JW2344","yfdC",99,2458783,2459692,909,"50M","False","f"
"4617","ECK2343-JW2345","intS",99,2460027,2461161,1134,"50M","False","f"
"4619","ECK2344-JW2346","yfdG",99,2461337,2461676,339,"50M","False","f"
"4621","ECK2345-JW2347","yfdH",99,2461696,2462593,897,"50M","False","f"
"4624","ECK2346-JW5382","yfdI",163,2462574,2462785,211,"50M","False","f"
"4625","ECK2347-JW5383","tfaS",99,2464285,2464564,279,"50M","False","f"
"4627","ECK2348-JW2350","yfdK",99,2464577,2464994,417,"50M","False","r"
"4629","ECK2349-JW5384","yfdL",99,2465044,2465713,669,"50M","False","r"
"4631","ECK2350-JW2352","yfdM",99,2465612,2465864,252,"50M","False","r"
"4633","ECK2351-JW5385","yfdN",99,2465887,2466358,471,"50M","False","r"
"4635","none-JW2353","none",99,2465913,2466075,162,"50M","False","f"
"4637","ECK2352-JW2355","yfdO",99,2466378,2466723,345,"50M","False","r"
"4639","ECK2353-JW2356","yfdP",99,2467002,2467425,423,"50M","False","f"
"4641","ECK2354-JW2357","yfdQ",99,2467514,2468315,801,"50M","False","f"
"4643","ECK2355-JW2358","yfdR",99,2468466,2468979,513,"50M","False","f"
"4645","ECK2356-JW2359","yfdS",99,2468993,2469332,339,"50M","False","f"
"4647","ECK2358-JW5386","ypdJ",99,2469355,2469637,282,"50M","False","f"
"4649","ECK2359-JW5387","torI",99,2469792,2469969,177,"50M","False","f"
"4651","ECK2360-JW2361","dsdC",99,2470194,2471106,912,"50M","False","r"
"4653","ECK2361-JW2362","dsdX",99,2471329,2472643,1314,"50M","False","f"
"4655","ECK2362-JW2363","dsdA",99,2472684,2473989,1305,"50M","False","f"
"4657","ECK2363-JW2364","emrY",99,2474138,2475653,1515,"50M","False","r"
"4659","ECK2364-JW2365","emrK",99,2475676,2476816,1140,"50M","False","r"
"4661","ECK2365-JW2366","evgA",99,2477237,2477828,591,"50M","False","f"
"4663","ECK2366-JW2367","evgS",97,2477856,2481426,3570,"50M","False","f"
"4665","ECK2367-JW2368","yfdE",99,2481523,2482645,1122,"50M","False","r"
"4667","ECK2368-JW2369","yfdV",99,2482742,2483663,921,"50M","False","r"
"4669","ECK2369-JW2370","oxc",99,2483756,2485427,1671,"50M","False","r"
"4671","ECK2370-JW2371","frc",99,2485504,2486731,1227,"50M","False","r"
"4673","ECK2371-JW2372","yfdX",99,2487267,2487879,612,"50M","False","r"
"4675","ECK2372-JW2373","ypdI",99,2488180,2488432,252,"50M","False","f"
"4677","ECK2373-JW2374","yfdY",99,2488550,2488769,219,"50M","False","r"
"4679","ECK2374-JW2375","ddg",99,2489127,2490024,897,"50M","False","f"
"4681","ECK2375-JW2376","yfdZ",99,2490557,2491772,1215,"50M","False","r"
"4683","ECK2376-JW5388","ypdA",99,2492171,2493827,1656,"50M","False","f"
"4685","ECK2377-JW2378","ypdB",99,2493865,2494576,711,"50M","False","f"
"4687","ECK2378-JW2379","ypdC",99,2494612,2495446,834,"50M","False","f"
"4689","ECK2379-JW2380","ypdD",99,2495490,2497962,2472,"50M","False","r"
"4691","ECK2380-JW2381","ypdE",99,2498010,2499024,1014,"50M","False","r"
"4693","ECK2381-JW2382","ypdF",99,2499047,2500109,1062,"50M","False","r"
"4695","ECK2382-JW2383","ypdG",99,2500147,2501371,1224,"50M","False","r"
"4697","ECK2383-JW5389","ypdH",99,2501416,2501770,354,"50M","False","r"
"4699","ECK2384-JW2385","glk",99,2501961,2502903,942,"50M","False","r"
"4701","ECK2385-JW2386","yfeO",99,2503112,2504345,1233,"50M","False","f"
"4703","ECK2386-JW2387","ypeC",99,2504483,2504786,303,"50M","False","f"
"4705","ECK2387-JW2388","mntH",99,2504968,2506183,1215,"50M","False","r"
"4707","ECK2388-JW2389","nupC",99,2506524,2507703,1179,"50M","False","f"
"4709","ECK2389-JW5391","yfeA",99,2509143,2511369,2226,"50M","False","r"
"4711","ECK2392-JW2393","yfeC",99,2511949,2512270,321,"50M","False","f"
"4713","ECK2393-JW2394","yfeD",99,2512295,2512664,369,"50M","False","f"
"4715","ECK2394-JW2395","gltX",99,2512757,2514149,1392,"50M","False","r"
"4717","ECK2399-JW2396","xapR",99,2514973,2515834,861,"50M","False","r"
"4719","none-JW5392","none",99,2515898,2516033,135,"50M","False","r"
"4721","ECK2400-JW2397","xapB",99,2516109,2517342,1233,"50M","False","r"
"4723","ECK2401-JW2398","xapA",99,2517425,2518235,810,"50M","False","r"
"4725","ECK2402-JW2399","yfeN",99,2518489,2519230,741,"50M","False","f"
"4727","ECK2403-JW2400","yfeR",99,2519310,2520213,903,"50M","False","r"
"4729","ECK2404-JW5876","yfeH",99,2520308,2521332,1024,"50M","False","f"
"4731","ECK2405-JW5877","ypeB",99,2521392,2521516,124,"45M1D5M","False","r"
"4733","ECK2406-JW2403","ligA",99,2521541,2523533,1992,"50M","False","r"
"4735","ECK2407-JW2404","zipA",99,2523627,2524590,963,"50M","False","r"
"4737","ECK2408-JW2406","cysZ",99,2524825,2525563,738,"50M","False","f"
"4739","ECK2409-JW2407","cysK",99,2525771,2526719,948,"50M","False","f"
"4741","ECK2410-JW2408","ptsH",99,2527126,2527360,234,"50M","False","f"
"4743","ECK2411-JW2409","ptsI",99,2527428,2529132,1704,"50M","False","f"
"4745","ECK2412-JW2410","crr",99,2529196,2529682,486,"50M","False","f"
"4747","ECK2413-JW2411","pdxK",99,2529766,2530594,828,"50M","False","r"
"4749","ECK2414-JW2412","yfeK",99,2530704,2531055,351,"50M","False","f"
"4751","ECK2415-JW2413","yfeS",99,2531111,2531822,711,"50M","False","f"
"4753","ECK2416-JW2414","cysM",99,2532052,2532940,888,"50M","False","r"
"4755","ECK2417-JW2415","cysA",99,2533097,2534171,1074,"50M","False","r"
"4757","ECK2418-JW2416","cysW",99,2534184,2535036,852,"50M","False","r"
"4759","ECK2419-JW2417","cysU",99,2535059,2535869,810,"50M","False","r"
"4761","ECK2420-JW2418","cysP",99,2535892,2536885,993,"50M","False","r"
"4763","ECK2421-JW5394","ucpA",99,2537212,2537980,768,"50M","False","r"
"4765","ECK2422-JW2420","yfeT",99,2538132,2538966,834,"50M","False","r"
"4767","ECK2423-JW2421","yfeU",99,2539135,2540008,873,"50M","False","f"
"4769","ECK2424-JW2422","murP",99,2540035,2541436,1401,"50M","False","f"
"4771","ECK2425-JW5395","yfeW",99,2541377,2542745,1368,"50M","False","f"
"4773","ECK2426-JW2424","yfeX",99,2543026,2543902,876,"50M","False","r"
"4775","ECK2427-JW2425","yfeY",99,2544021,2544573,552,"50M","False","r"
"4777","ECK2428-JW2426","yfeZ",99,2544657,2545083,426,"50M","False","r"
"4779","ECK2429-JW2427","ypeA",99,2545093,2545495,402,"50M","False","r"
"4781","ECK2430-JW2428","amiA",99,2545714,2546560,846,"50M","False","f"
"4783","ECK2431-JW2429","hemF",99,2546587,2547463,876,"50M","False","f"
"4785","ECK2432-JW2430","yfeG",99,2547510,2548539,1029,"50M","False","r"
"4787","ECK2433-JW2431","yffI",99,2548608,2549085,477,"50M","False","r"
"4789","ECK2434-JW2432","eutL",99,2549121,2549757,636,"50M","False","r"
"4791","ECK2435-JW2433","eutC",99,2549790,2550654,864,"50M","False","r"
"4793","ECK2436-JW2434","eutB",99,2550698,2552036,1338,"50M","False","r"
"4795","ECK2446-JW2435","eutA",99,2558890,2560241,1351,"29S21M","False","r"
"4797","ECK2447-JW2436","eutH",99,2560261,2561464,1203,"50M","False","r"
"4799","ECK2448-JW2437","eutG",99,2561704,2562868,1164,"50M","False","r"
"4801","ECK2449-JW2438","eutJ",99,2562881,2563694,813,"50M","False","r"
"4803","ECK2450-JW2439","eutE",99,2563728,2565108,1380,"50M","False","r"
"4805","ECK2451-JW2440","cchB",99,2565143,2565407,264,"50M","False","r"
"4807","ECK2452-JW2441","cchA",99,2565537,2565807,270,"50M","False","r"
"4809","ECK2453-JW2442","eutI",99,2565869,2566862,993,"50M","False","r"
"4811","ECK2454-JW2443","eutT",99,2566882,2567662,780,"50M","False","r"
"4813","ECK2455-JW2444","eutQ",99,2567682,2568360,678,"50M","False","r"
"4815","ECK2456-JW2445","eutP",99,2568358,2568814,456,"50M","False","r"
"4817","ECK2457-JW2446","ypfE",99,2568850,2569162,312,"50M","False","r"
"4819","ECK2458-JW2447","maeB",99,2569478,2571734,2256,"50M","False","r"
"4821","ECK2459-JW2448","talA",99,2572028,2572955,927,"50M","False","f"
"4823","ECK2460-JW2449","tktB",99,2572998,2574978,1980,"50M","False","f"
"4825","ECK2461-JW2450","ypfG",99,2575114,2576134,1020,"50M","False","r"
"4827","ECK2462-JW2451","yffH",99,2576283,2576835,552,"50M","False","r"
"4829","ECK2463-JW2452","aegA",99,2576926,2578882,1956,"50M","False","r"
"4831","ECK2464-JW2453","narQ",99,2579093,2580770,1677,"50M","False","f"
"4833","ECK2465-JW2454","acrD",99,2580957,2584047,3090,"50M","False","f"
"4835","ECK2466-JW2455","yffB",99,2584609,2584942,333,"50M","False","f"
"4837","ECK2467-JW2456","dapE",99,2584969,2586073,1104,"50M","False","f"
"4839","ECK2468-JW2457","ypfN",99,2586124,2586301,177,"50M","False","f"
"4841","ECK2469-JW5396","ypfH",99,2586452,2587151,699,"50M","False","r"
"4843","ECK2470-JW2459","ypfI",99,2587224,2589216,1992,"50M","False","r"
"4845","ECK2471-JW2460","ypfJ",99,2589254,2590094,840,"50M","False","r"
"4847","ECK2472-JW2461","purC",99,2590285,2590975,690,"50M","False","r"
"4849","ECK2473-JW2462","nlpB",99,2591211,2592222,1011,"50M","False","r"
"4851","ECK2474-JW2463","dapA",99,2592262,2593117,855,"50M","False","r"
"4853","ECK2475-JW2464","gcvR",99,2593268,2593817,549,"50M","False","f"
"4855","ECK2476-JW2465","bcp",99,2593840,2594287,447,"50M","False","f"
"4857","ECK2477-JW2466","hyfA",99,2594563,2595157,594,"50M","False","f"
"4859","ECK2478-JW2467","hyfB",99,2595180,2597175,1995,"50M","False","f"
"4861","ECK2479-JW2468","hyfC",99,2597209,2598133,924,"50M","False","f"
"4863","ECK2480-JW2469","hyfD",99,2598173,2599589,1416,"50M","False","f"
"4865","ECK2481-JW2470","hyfE",99,2599624,2600251,627,"50M","False","f"
"4867","ECK2482-JW2471","hyfF",99,2600279,2601836,1557,"50M","False","f"
"4869","ECK2483-JW2472","hyfG",99,2601849,2603493,1644,"50M","False","f"
"4871","ECK2484-JW2473","hyfH",99,2603526,2604048,522,"50M","False","f"
"4873","ECK2485-JW5805","hyfI",99,2604068,2604800,732,"50M","False","f"
"4875","ECK2486-JW2475","hyfJ",99,2604820,2605209,389,"37M1I12M","False","f"
"4877","ECK2487-JW2476","hyfR",99,2605262,2607251,1989,"50M","False","f"
"4879","ECK2488-JW2477","focB",99,2607296,2608121,825,"50M","False","f"
"4881","ECK2489-JW2478","yfgO",99,2608200,2609238,1038,"50M","False","r"
"4883","ECK2490-JW2479","yfgC",99,2609456,2610896,1440,"50M","False","f"
"4885","ECK2491-JW2480","yfgD",99,2610940,2611276,336,"50M","False","f"
"4887","ECK2492-JW5397","hda",99,2611455,2612178,723,"50M","False","r"
"4889","ECK2493-JW2482","uraA",99,2612251,2613517,1266,"50M","False","r"
"4891","ECK2494-JW2483","upp",99,2613626,2614229,603,"50M","False","r"
"4893","ECK2495-JW2484","purM",99,2614559,2615573,1014,"50M","False","f"
"4895","ECK2496-JW2485","purN",99,2615596,2616211,615,"50M","False","f"
"4897","ECK2497-JW2486","ppk",99,2616406,2618449,2043,"50M","False","f"
"4899","ECK2498-JW2487","ppx",99,2618477,2619995,1518,"50M","False","f"
"4901","ECK2499-JW2488","yfgF",99,2620075,2622295,2220,"50M","False","r"
"4903","none-JW5398","none",99,2622500,2622629,129,"50M","False","r"
"4905","ECK2500-JW5399","yfgG",99,2622652,2622820,168,"50M","False","f"
"4907","ECK2501-JW5400","yfgH",99,2623157,2623649,492,"50M","False","f"
"4909","ECK2502-JW2490","yfgI",99,2623688,2624204,516,"50M","False","f"
"4911","ECK2503-JW2491","guaA",99,2624338,2625892,1554,"50M","False","r"
"4913","ECK2504-JW5401","guaB",99,2625984,2627427,1443,"50M","False","r"
"4915","ECK2505-JW2493","xseA",99,2627594,2628941,1347,"50M","False","f"
"4917","ECK2506-JW5402","yfgJ",99,2628979,2629207,228,"50M","False","r"
"4919","ECK2507-JW5403","der",99,2629264,2630713,1449,"50M","False","r"
"4921","ECK2508-JW2496","yfgL",99,2630854,2632009,1155,"50M","False","r"
"4923","ECK2509-JW2497","yfgM",99,2632043,2632640,597,"50M","False","r"
"4925","ECK2510-JW2498","hisS",99,2632681,2633932,1251,"50M","False","r"
"4927","ECK2511-JW2499","ispG",99,2634066,2635161,1095,"50M","False","r"
"4929","ECK2512-JW2500","yfgA",99,2635211,2636201,990,"50M","False","r"
"4931","ECK2513-JW2501","yfgB",99,2636509,2637640,1131,"50M","False","r"
"4933","ECK2514-JW2502","ndk",99,2637813,2638221,408,"50M","False","r"
"4935","ECK2515-JW2503","pbpC",99,2638393,2640682,2289,"50M","False","r"
"4937","ECK2516-JW2504","yfhM",97,2640706,2645644,4938,"50M","False","r"
"4939","ECK2517-JW2505","sseA",99,2645856,2646678,822,"50M","False","f"
"4941","ECK2519-JW5404","sseB",99,2647537,2648155,618,"50M","False","r"
"4943","ECK2520-JW2507","pepB",99,2648455,2649715,1260,"50M","False","r"
"4945","ECK2521-JW2508","yfhJ",99,2649916,2650093,177,"50M","False","r"
"4947","ECK2522-JW2509","fdx",99,2650128,2650440,312,"50M","False","r"
"4949","ECK2523-JW2510","hscA",99,2650465,2652292,1827,"50M","False","r"
"4951","ECK2524-JW2511","hscB",99,2652332,2652824,492,"50M","False","r"
"4953","ECK2525-JW2512","iscA",99,2652943,2653243,300,"50M","False","r"
"4955","ECK2526-JW2513","iscU",99,2653283,2653646,363,"50M","False","r"
"4957","ECK2527-JW2514","iscS",99,2653697,2654888,1191,"50M","False","r"
"4959","ECK2528-JW2515","iscR",99,2655023,2655488,465,"50M","False","r"
"4961","ECK2529-JW2516","yfhQ",99,2655963,2656680,717,"50M","False","r"
"4963","ECK2530-JW2517","suhB",99,2656804,2657584,780,"50M","False","f"
"4965","ECK2531-JW2518","yfhR",99,2657725,2658583,858,"50M","False","f"
"4967","ECK2532-JW5878","csiE",99,2658797,2660164,1367,"50M","False","f"
"4969","ECK2533-JW2520","hcaT",99,2660087,2661203,1116,"50M","False","r"
"4971","ECK2534-JW2521","hcaR",99,2661386,2662253,867,"50M","False","r"
"4973","ECK2535-JW2522","hcaE",99,2662394,2663732,1338,"50M","False","f"
"4975","ECK2536-JW2523","hcaF",99,2663752,2664247,495,"50M","False","f"
"4977","ECK2537-JW2524","hcaC",99,2664270,2664567,297,"50M","False","f"
"4979","ECK2538-JW2525","hcaB",99,2664587,2665376,789,"50M","False","f"
"4981","ECK2539-JW2526","hcaD",99,2665409,2666588,1179,"50M","False","f"
"4983","ECK2540-JW2527","yphA",99,2666636,2667107,471,"50M","False","f"
"4985","ECK2541-JW2528","yphB",99,2667196,2668045,849,"50M","False","r"
"4987","ECK2542-JW5842","yphC",99,2668080,2669151,1071,"50M","False","r"
"4989","ECK2543-JW2530","yphD",99,2669207,2670182,975,"50M","False","r"
"4991","ECK2544-JW2531","yphE",99,2670230,2671718,1488,"50M","False","r"
"4993","ECK2545-JW2532","yphF",99,2671764,2672724,960,"50M","False","r"
"4995","ECK2546-JW5405","yphG",99,2672844,2676195,3351,"50M","False","r"
"4997","ECK2547-JW5406","yphH",99,2676219,2677395,1176,"50M","False","f"
"4999","ECK2548-JW2535","glyA",99,2677634,2678864,1230,"50M","False","r"
"5001","ECK2549-JW2536","hmp",99,2679197,2680364,1167,"50M","False","f"
"5003","ECK2550-JW2537","glnB",99,2680450,2680765,315,"50M","False","r"
"5005","ECK2551-JW2538","yfhA",99,2680849,2682160,1311,"50M","False","r"
"5007","ECK2552-JW2539","yfhG",99,2682173,2682863,690,"50M","False","r"
"5009","ECK2553-JW5407","yfhK",99,2683051,2684410,1359,"50M","False","r"
"5011","ECK2555-JW2541","purL",97,2685036,2688900,3864,"50M","False","r"
"5013","ECK2556-JW2542","yfhD",99,2689301,2690696,1395,"50M","False","f"
"5015","ECK2557-JW2543","tadA",99,2690734,2691247,513,"50M","False","r"
"5017","ECK2558-JW5408","yfhB",99,2691295,2691844,549,"50M","False","r"
"5019","ECK2559-JW2545","yfhH",99,2692121,2692946,825,"50M","False","f"
"5021","ECK2560-JW2546","yfhL",99,2693025,2693262,237,"50M","False","f"
"5023","ECK2561-JW2547","acpS",99,2693998,2694355,357,"50M","False","r"
"5025","ECK2562-JW2548","pdxJ",99,2694378,2695086,708,"50M","False","r"
"5027","ECK2563-JW2549","recO",99,2695121,2695826,705,"50M","False","r"
"5029","ECK2564-JW2550","era",99,2695861,2696743,882,"50M","False","r"
"5031","ECK2565-JW2551","rnc",99,2696763,2697420,657,"50M","False","r"
"5033","ECK2566-JW2552","lepB",99,2697715,2698666,951,"50M","False","r"
"5035","ECK2567-JW2553","lepA",99,2698705,2700481,1776,"50M","False","r"
"5037","ECK2568-JW2554","rseC",99,2700702,2701158,456,"50M","False","r"
"5039","ECK2569-JW2555","rseB",99,2701178,2702111,933,"50M","False","r"
"5041","ECK2570-JW2556","rseA",99,2702137,2702761,624,"50M","False","r"
"5043","ECK2571-JW2557","rpoE",99,2702817,2703369,552,"50M","False","r"
"5045","ECK2572-JW2558","nadB",99,2703782,2705381,1599,"50M","False","f"
"5047","ECK2573-JW2559","yfiC",99,2705407,2706121,714,"50M","False","r"
"5049","ECK2574-JW2560","srmB",99,2706258,2707569,1311,"50M","False","f"
"5051","ECK2575-JW2561","yfiE",99,2707819,2708677,858,"50M","False","r"
"5053","ECK2576-JW2562","yfiK",99,2708785,2709349,564,"50M","False","f"
"5055","ECK2577-JW2563","yfiD",99,2709446,2709806,360,"50M","False","r"
"5057","ECK2578-JW2564","ung",99,2710116,2710782,666,"50M","False","f"
"5059","ECK2579-JW2565","yfiF",99,2710871,2711885,1014,"50M","False","r"
"5061","ECK2580-JW2566","trxC",99,2712097,2712493,396,"50M","False","f"
"5063","ECK2581-JW5409","yfiP",99,2712561,2713260,699,"50M","False","f"
"5065","ECK2582-JW2568","yfiQ",99,2713315,2715952,2637,"50M","False","f"
"5067","ECK2583-JW2569","pssA",99,2716089,2717421,1332,"50M","False","f"
"5069","ECK2584-JW2570","yfiM",99,2717541,2717790,249,"50M","False","f"
"5071","ECK2585-JW2571","kgtP",99,2717828,2719103,1275,"50M","False","r"
"5073","none-JW5410","none",99,2719108,2719192,84,"50M","False","r"
"5075","none-JW5411","none",99,2719239,2719326,87,"50M","False","f"
"5077","ECK2590-JW2573","clpB",99,2724980,2727530,2550,"50M","False","r"
"5079","ECK2591-JW2575","yfiH",99,2727683,2728391,708,"50M","False","r"
"5081","ECK2592-JW2576","rluD",99,2728411,2729368,957,"50M","False","r"
"5083","ECK2593-JW2577","yfiO",99,2729508,2730222,714,"50M","False","f"
"5085","ECK2594-JW2578","yfiA",99,2730516,2730834,318,"50M","False","f"
"5087","ECK2595-JW2579","pheL",99,2730961,2730985,24,"50M","False","f"
"5089","ECK2596-JW2580","pheA",99,2731107,2732244,1137,"50M","False","f"
"5091","ECK2597-JW2581","tyrA",99,2732328,2733426,1098,"50M","False","r"
"5093","ECK2598-JW2582","aroF",99,2733460,2734507,1047,"50M","False","r"
"5095","ECK2599-JW5412","yfiL",99,2734683,2735064,381,"50M","False","f"
"5097","ECK2600-JW2584","yfiR",99,2735237,2735732,495,"50M","False","f"
"5099","ECK2601-JW2585","yfiN",99,2735745,2736948,1203,"50M","False","f"
"5101","ECK2602-JW2586","yfiB",99,2736987,2737446,459,"50M","False","f"
"5103","ECK2603-JW2587","rplS",99,2737563,2737887,324,"50M","False","r"
"5105","ECK2604-JW2588","trmD",99,2737952,2738696,744,"50M","False","r"
"5107","ECK2605-JW5413","rimM",99,2738750,2739275,525,"50M","False","r"
"5109","ECK2606-JW2590","rpsP",99,2739317,2739542,225,"50M","False","r"
"5111","ECK2607-JW5414","ffh",99,2739814,2741152,1338,"50M","False","r"
"5113","ECK2608-JW2592","ypjD",99,2741249,2742092,843,"50M","False","f"
"5115","ECK2609-JW5415","yfjD",99,2742181,2743399,1218,"50M","False","f"
"5117","ECK2610-JW2594","grpE",99,2743495,2744065,570,"50M","False","r"
"5119","ECK2611-JW2596","yfjB",99,2744193,2745048,855,"50M","False","f"
"5121","ECK2612-JW5416","recN",99,2745157,2746795,1638,"50M","False","f"
"5123","ECK2613-JW2598","smpA",99,2746967,2747285,318,"50M","False","f"
"5125","ECK2614-JW2599","yfjF",99,2747388,2747655,267,"50M","False","r"
"5127","ECK2615-JW2600","yfjG",99,2747668,2748121,453,"50M","False","r"
"5129","ECK2616-JW2601","smpB",99,2748258,2748717,459,"50M","False","f"
"5131","ECK2618-JW2602","intA",99,2749521,2750739,1218,"50M","False","f"
"5133","ECK2619-JW2603","yfjH",99,2751024,2751957,933,"50M","False","r"
"5135","ECK2620-JW2604","alpA",99,2752006,2752195,189,"50M","False","f"
"5137","ECK2621-JW2605","yfjI",99,2752347,2753733,1386,"50M","False","f"
"5139","ECK2622-JW2607","yfjJ",99,2753909,2754512,603,"50M","False","f"
"5141","ECK2623-JW2608","yfjK",99,2754731,2756897,2166,"50M","False","r"
"5143","ECK2624-JW2609","yfjL",99,2756917,2758510,1593,"50M","False","r"
"5145","none-JW5417","none",99,2758594,2758687,93,"50M","False","r"
"5147","ECK2625-JW2610","yfjM",99,2758893,2759133,240,"50M","False","r"
"5149","ECK2626-JW2611","yfjN",99,2759280,2760330,1050,"50M","False","f"
"5151","ECK2627-JW5418","yfjO",99,2760397,2760694,297,"50M","False","f"
"5153","ECK2628-JW5419","yfjP",99,2761066,2761912,846,"50M","False","f"
"5155","ECK2629-JW2614","yfjQ",99,2762027,2762825,798,"50M","False","f"
"5157","ECK2630-JW2615","yfjR",99,2763065,2763743,678,"50M","False","f"
"5159","ECK2632-JW5921","yfjS",99,2763794,2764463,669,"50M","False","f"
"5161","ECK2633-JW2618","yfjT",99,2764510,2764954,444,"50M","False","f"
"5163","ECK2634-JW2619","yfjU",99,2765220,2765511,291,"50M","False","r"
"5165","ECK2635-JW5922","ypjL",99,2765547,2766117,570,"50M","False","r"
"5167","ECK2636-JW2621","yfjV",99,2766216,2766393,177,"50M","False","r"
"5169","ECK2637-JW5420","ypjM",99,2766356,2766449,93,"50M","False","r"
"5171","ECK2638-JW2623","yfjW",99,2766680,2768360,1680,"50M","False","f"
"5173","ECK2639-JW2624","yfjX",99,2769281,2769716,435,"50M","False","f"
"5175","ECK2640-JW2625","yfjY",99,2769748,2770207,459,"50M","False","f"
"5177","ECK2641-JW5421","ypjJ",99,2770239,2770416,177,"50M","False","f"
"5179","ECK2642-JW2626","yfjZ",99,2770477,2770771,294,"50M","False","f"
"5181","ECK2643-JW2627","ypjF",99,2770815,2771121,306,"50M","False","f"
"5183","ECK2644-JW5422","ypjA",97,2771526,2776212,4686,"50M","False","r"
"5185","ECK2645-JW5423","pinH",99,2776445,2776565,120,"50M","False","r"
"5187","ECK2646-JW2629","ypjB",99,2777018,2777786,768,"50M","False","r"
"5189","ECK2647-JW5424","ypjC",99,2777909,2778284,375,"50M","False","r"
"5191","ECK2649-JW5425","ygaQ",99,2779759,2780068,309,"50M","False","f"
"5193","ECK2650-JW2631","ygaR",99,2780110,2780773,663,"50M","False","f"
"5195","ECK2651-JW5426","yqaC",99,2781187,2781577,390,"50M","False","f"
"5197","ECK2652-JW2633","yqaD",99,2781739,2781988,249,"50M","False","f"
"5199","ECK2653-JW5427","ygaT",99,2782242,2783301,1059,"50M","False","f"
"5201","ECK2654-JW2635","ygaF",99,2783344,2784589,1245,"50M","False","f"
"5203","ECK2655-JW2636","gabD",99,2784635,2786060,1425,"50M","False","f"
"5205","ECK2656-JW2637","gabT",99,2786097,2787354,1257,"50M","False","f"
"5207","ECK2657-JW2638","gabP",99,2787615,2788992,1377,"50M","False","f"
"5209","ECK2658-JW2639","csiR",99,2789036,2789675,639,"50M","False","f"
"5211","ECK2659-JW2640","ygaU",99,2789717,2790143,426,"50M","False","r"
"5213","ECK2660-JW2641","yqaE",99,2790250,2790385,135,"50M","False","r"
"5215","ECK2661-JW2642","ygaV",99,2790573,2790849,276,"50M","False","f"
"5217","ECK2662-JW2643","ygaP",99,2790882,2791383,501,"50M","False","f"
"5219","ECK2663-JW2644","stpA",99,2791471,2791852,381,"50M","False","r"
"5221","ECK2664-JW2645","ygaW",99,2792526,2792952,426,"50M","False","f"
"5223","ECK2665-JW2646","ygaC",99,2793030,2793351,321,"50M","False","r"
"5225","ECK2666-JW2647","ygaM",99,2793496,2793814,318,"50M","False","f"
"5227","ECK2667-JW2648","nrdH",99,2794085,2794307,222,"50M","False","f"
"5229","ECK2668-JW2649","nrdI",99,2794327,2794714,387,"50M","False","f"
"5231","ECK2669-JW2650","nrdE",99,2794710,2796831,2121,"50M","False","f"
"5233","ECK2670-JW2651","nrdF",99,2796864,2797800,936,"50M","False","f"
"5235","ECK2671-JW2652","proV",99,2798177,2799356,1179,"50M","False","f"
"5237","ECK2672-JW2653","proW",99,2799372,2800413,1041,"50M","False","f"
"5239","ECK2673-JW2654","proX",99,2800494,2801463,969,"50M","False","f"
"5241","ECK2674-JW2655","ygaX",99,2801678,2801921,243,"50M","False","f"
"5243","ECK2675-JW5428","ygaY",99,2801938,2802832,894,"50M","False","f"
"5245","ECK2676-JW2657","ygaZ",99,2802979,2803693,714,"50M","False","f"
"5247","ECK2677-JW2658","ygaH",99,2803706,2804018,312,"50M","False","f"
"5249","ECK2678-JW2659","mprA",99,2804132,2804639,507,"50M","False","f"
"5251","ECK2679-JW2660","emrA",99,2804789,2805938,1149,"50M","False","f"
"5253","ECK2680-JW2661","emrB",99,2805978,2807493,1515,"50M","False","f"
"5255","ECK2681-JW2662","luxS",99,2807598,2808090,492,"50M","False","r"
"5257","ECK2683-JW2663","gshA",99,2808263,2809796,1533,"50M","False","r"
"5259","ECK2684-JW2664","yqaA",99,2809892,2810297,405,"50M","False","r"
"5261","ECK2685-JW2665","yqaB",99,2810317,2810860,543,"50M","False","r"
"5263","ECK2691-JW2666","csrA",99,2812341,2812503,162,"50M","False","r"
"5265","ECK2692-JW2667","alaS",99,2812761,2815368,2607,"50M","False","r"
"5267","ECK2693-JW2668","recX",99,2815519,2815996,477,"50M","False","r"
"5269","ECK2694-JW2669","recA",99,2816088,2817126,1038,"50M","False","r"
"5271","ECK2695-JW2670","ygaD",99,2817229,2817703,474,"50M","False","r"
"5273","ECK2696-JW2671","mltB",99,2817871,2818933,1062,"50M","False","r"
"5275","ECK2697-JW5429","srlA",99,2819194,2819734,540,"50M","False","f"
"5277","ECK2698-JW5430","srlE",99,2819754,2820690,936,"50M","False","f"
"5279","ECK2699-JW2673","srlB",99,2820724,2821072,348,"50M","False","f"
"5281","ECK2700-JW2674","srlD",99,2821099,2821855,756,"50M","False","f"
"5283","ECK2701-JW2675","gutM",99,2821983,2822319,336,"50M","False","f"
"5285","ECK2702-JW2676","srlR",99,2822409,2823159,750,"50M","False","f"
"5287","ECK2703-JW5431","gutQ",99,2823214,2824117,903,"50M","False","f"
"5289","ECK2704-JW5843","norR",99,2824155,2824644,489,"50M","False","r"
"5291","ECK2705-JW2680","norV",99,2825838,2827254,1416,"50M","False","f"
"5293","ECK2706-JW2681","norW",99,2827274,2828384,1110,"50M","False","f"
"5295","ECK2707-JW5433","hypF",99,2828553,2830782,2229,"50M","False","r"
"5297","ECK2708-JW2683","hydN",99,2830958,2831462,504,"50M","False","r"
"5299","ECK2709-JW5434","ascG",99,2831634,2832624,990,"50M","False","r"
"5301","ECK2710-JW5435","ascF",99,2832886,2834320,1434,"50M","False","f"
"5303","ECK2711-JW2686","ascB",99,2834352,2835753,1401,"50M","False","f"
"5305","ECK2712-JW2687","hycI",99,2835953,2836400,447,"50M","False","r"
"5307","ECK2713-JW2688","hycH",99,2836416,2836803,387,"50M","False","r"
"5309","ECK2714-JW2689","hycG",99,2836823,2837567,744,"50M","False","r"
"5311","ECK2715-JW2690","hycF",99,2837590,2838109,519,"50M","False","r"
"5313","ECK2716-JW2691","hycE",99,2838142,2839828,1686,"50M","False","r"
"5315","ECK2717-JW2692","hycD",99,2839869,2840769,900,"50M","False","r"
"5317","ECK2718-JW2693","hycC",99,2840795,2842598,1803,"50M","False","r"
"5319","ECK2719-JW2694","hycB",99,2842618,2843206,588,"50M","False","r"
"5321","ECK2720-JW2695","hycA",99,2843354,2843792,438,"50M","False","r"
"5323","ECK2721-JW2696","hypA",99,2844009,2844336,327,"50M","False","f"
"5325","ECK2722-JW2697","hypB",99,2844363,2845212,849,"50M","False","f"
"5327","ECK2723-JW2698","hypC",99,2845226,2845475,249,"50M","False","f"
"5329","ECK2724-JW2699","hypD",99,2845498,2846596,1098,"50M","False","f"
"5331","ECK2725-JW2700","hypE",99,2846658,2847603,945,"50M","False","f"
"5333","ECK2726-JW2701","fhlA",99,2847700,2849755,2055,"50M","False","f"
"5335","ECK2727-JW2702","ygbA",99,2849833,2850163,330,"50M","False","r"
"5337","none-JW5436","none",99,2850263,2850374,111,"50M","False","r"
"5339","ECK2728-JW2703","mutS",99,2850455,2852993,2538,"50M","False","f"
"5341","ECK2729-JW2704","pphB",99,2853122,2853755,633,"50M","False","f"
"5343","ECK2730-JW2705","ygbI",99,2853847,2854621,774,"50M","False","r"
"5345","ECK2731-JW2706","ygbJ",99,2854792,2855677,885,"50M","False","f"
"5347","ECK2732-JW2707","ygbK",99,2855697,2856840,1143,"50M","False","f"
"5349","ECK2733-JW2708","ygbL",99,2856955,2857570,615,"50M","False","f"
"5351","ECK2734-JW2709","ygbM",99,2857598,2858351,753,"50M","False","f"
"5353","ECK2735-JW2710","ygbN",99,2858463,2859804,1341,"50M","False","f"
"5355","ECK2736-JW5437","rpoS",99,2859939,2860908,969,"50M","False","r"
"5357","ECK2737-JW2712","nlpD",99,2860994,2862110,1116,"50M","False","r"
"5359","ECK2738-JW2713","pcm",99,2862273,2862876,603,"50M","False","r"
"5361","ECK2739-JW2714","surE",99,2862893,2863631,738,"50M","False","r"
"5363","ECK2740-JW2715","truD",99,2863635,2864661,1026,"50M","False","r"
"5365","ECK2741-JW2716","ispF",99,2864681,2865137,456,"50M","False","r"
"5367","ECK2742-JW2717","ispD",99,2865160,2865847,687,"50M","False","r"
"5369","ECK2743-JW2718","ftsB",99,2865889,2866177,288,"50M","False","r"
"5371","ECK2744-JW2719","ygbE",99,2866394,2866694,300,"50M","False","r"
"5373","ECK2745-JW2720","cysC",99,2866767,2867349,582,"50M","False","r"
"5375","ECK2746-JW2721","cysN",99,2867372,2868776,1404,"50M","False","r"
"5377","ECK2747-JW2722","cysD",99,2868801,2869686,885,"50M","False","r"
"5379","ECK2748-JW2723","iap",99,2869943,2870957,1014,"50M","False","f"
"5381","ECK2749-JW5438","ygbF",99,2871949,2872276,327,"50M","False","r"
"5383","ECK2750-JW2725","ygbT",99,2872235,2873129,894,"50M","False","r"
"5385","ECK2751-JW2726","ygcH",99,2873168,2873744,576,"50M","False","r"
"5387","ECK2752-JW5844","ygcI",99,2873754,2874405,651,"50M","False","r"
"5389","ECK2753-JW2728","ygcJ",99,2874431,2875499,1068,"50M","False","r"
"5391","ECK2754-JW2729","ygcK",99,2875535,2875994,459,"50M","False","r"
"5393","ECK2755-JW2730","ygcL",99,2876010,2877495,1485,"50M","False","r"
"5395","ECK2756-JW2731","ygcB",99,2877933,2880576,2643,"50M","False","r"
"5397","ECK2757-JW2732","cysH",99,2880958,2881669,711,"50M","False","r"
"5399","ECK2758-JW2733","cysI",99,2881767,2883456,1689,"50M","False","r"
"5401","ECK2759-JW2734","cysJ",99,2883479,2885255,1776,"50M","False","r"
"5403","ECK2760-JW2735","ygcM",99,2885576,2885918,342,"50M","False","f"
"5405","ECK2761-JW2736","ygcN",99,2886019,2887267,1248,"50M","False","f"
"5407","ECK2762-JW2737","ygcO",99,2887281,2887518,237,"50M","False","f"
"5409","ECK2763-JW2738","ygcP",99,2887558,2888110,552,"50M","False","f"
"5411","ECK2764-JW5440","ygcQ",99,2888299,2889169,870,"50M","False","r"
"5413","ECK2765-JW5441","ygcR",99,2889226,2889912,686,"47M3S","False","r"
"5415","ECK2766-JW5845","ygcS",99,2889913,2891299,1386,"50M","False","r"
"5417","ECK2767-JW5442","ygcU",99,2891344,2892115,771,"50M","False","r"
"5419","ECK2768-JW5443","ygcW",99,2892868,2893705,837,"50M","False","r"
"5421","ECK2769-JW2746","yqcE",99,2893954,2895208,1254,"50M","False","f"
"5423","ECK2770-JW5444","ygcE",99,2895612,2896713,1101,"50M","False","f"
"5425","ECK2771-JW2748","ygcF",99,2898127,2898775,648,"50M","False","r"
"5427","ECK2772-JW5445","ygcG",99,2899004,2899922,918,"50M","False","f"
"5429","ECK2773-JW2750","eno",99,2900023,2901298,1275,"50M","False","r"
"5431","ECK2774-JW2751","pyrG",99,2901409,2903023,1614,"50M","False","r"
"5433","ECK2775-JW2752","mazG",99,2903274,2904042,768,"50M","False","r"
"5435","ECK2776-JW2753","chpA",99,2904136,2904448,312,"50M","False","r"
"5437","ECK2777-JW2754","chpR",99,2904471,2904696,225,"50M","False","r"
"5439","ECK2778-JW2755","relA",99,2904797,2907008,2211,"50M","False","r"
"5441","ECK2779-JW2756","rumA",99,2907079,2908357,1278,"50M","False","r"
"5443","ECK2780-JW2757","barA",99,2908419,2911152,2733,"50M","False","f"
"5445","ECK2781-JW2758","gudD",99,2911425,2912742,1317,"50M","False","r"
"5447","ECK2782-JW2759","gudX",99,2912786,2914103,1317,"50M","False","r"
"5449","ECK2783-JW2760","gudP",99,2914128,2915457,1329,"50M","False","r"
"5451","ECK2784-JW2761","yqcA",99,2915915,2916341,426,"50M","False","r"
"5453","ECK2785-JW2762","yqcB",99,2916382,2917141,759,"50M","False","r"
"5455","ECK2786-JW2763","yqcC",99,2917164,2917470,306,"50M","False","r"
"5457","ECK2788-JW2764","syd",99,2918115,2918637,522,"50M","False","r"
"5459","ECK2789-JW2765","yqcD",99,2918710,2919535,825,"50M","False","f"
"5461","ECK2790-JW2766","ygdH",99,2919670,2921011,1341,"50M","False","f"
"5463","ECK2791-JW2767","sdaC",99,2921591,2922857,1266,"50M","False","f"
"5465","ECK2792-JW2768","sdaB",99,2922938,2924282,1344,"50M","False","f"
"5467","ECK2793-JW5446","exo",99,2924327,2925149,822,"50M","False","f"
"5469","ECK2794-JW2770","fucO",99,2925245,2926373,1128,"50M","False","r"
"5471","ECK2795-JW2771","fucA",99,2926421,2927045,624,"50M","False","r"
"5473","ECK2796-JW2772","fucP",99,2927597,2928890,1293,"50M","False","f"
"5475","ECK2797-JW2773","fucI",99,2928946,2930698,1752,"50M","False","f"
"5477","ECK2798-JW2774","fucK",99,2930800,2932225,1425,"50M","False","f"
"5479","ECK2799-JW2775","fucU",99,2932250,2932649,399,"50M","False","f"
"5481","ECK2800-JW2776","fucR",99,2932730,2933438,708,"50M","False","f"
"5483","ECK2801-JW2777","ygdE",99,2933523,2934600,1077,"50M","False","r"
"5485","none-JW5447","none",99,2933701,2933875,174,"50M","False","f"
"5487","ECK2802-JW2778","ygdD",99,2934616,2934988,372,"50M","False","r"
"5489","ECK2803-JW2779","gcvA",99,2935030,2935924,894,"50M","False","r"
"5491","ECK2805-JW5448","ygdI",99,2936298,2936505,207,"50M","False","r"
"5493","ECK2806-JW2781","csdA",99,2936699,2937881,1182,"50M","False","f"
"5495","ECK2807-JW2782","ygdK",99,2937904,2938324,420,"50M","False","f"
"5497","ECK2808-JW2783","ygdL",99,2938416,2939199,783,"50M","False","r"
"5499","ECK2809-JW2784","mltA",99,2939461,2940535,1074,"50M","False","r"
"5501","ECK2813-JW5449","amiC",99,2941137,2942367,1230,"50M","False","r"
"5503","ECK2814-JW2786","argA",99,2942604,2943912,1308,"50M","False","f"
"5505","ECK2815-JW2787","recD",99,2944015,2945818,1803,"50M","False","r"
"5507","ECK2816-JW2788","recB",97,2945841,2949360,3519,"50M","False","r"
"5509","ECK2817-JW2789","ptr",99,2949376,2952241,2865,"50M","False","r"
"5511","ECK2818-JW2790","recC",99,2952440,2955785,3345,"50M","False","r"
"5513","ECK2819-JW2791","ppdC",99,2955821,2956121,300,"50M","False","r"
"5515","ECK2820-JW5450","ygdB",99,2956129,2956471,342,"50M","False","r"
"5517","ECK2821-JW5451","ppdB",99,2956533,2957313,780,"50M","False","r"
"5519","ECK2822-JW2794","ppdA",99,2957087,2957534,447,"50M","False","r"
"5521","ECK2823-JW2795","thyA",99,2957741,2958512,771,"50M","False","r"
"5523","ECK2824-JW2796","lgt",99,2958542,2959394,852,"50M","False","r"
"5525","ECK2825-JW2797","ptsP",99,2959568,2961791,2223,"50M","False","r"
"5527","ECK2826-JW2798","nudH",99,2961827,2962334,507,"50M","False","r"
"5529","none-JW5452","none",99,2962651,2962822,171,"50M","False","f"
"5531","ECK2827-JW2799","mutH",99,2963024,2963690,666,"50M","False","f"
"5533","ECK2828-JW2800","ygdQ",99,2963782,2964472,690,"50M","False","f"
"5535","ECK2829-JW2801","ygdR",99,2964633,2964828,195,"50M","False","f"
"5537","ECK2830-JW2802","tas",99,2964959,2965976,1017,"50M","False","f"
"5539","ECK2831-JW2803","ygeD",99,2966049,2967219,1170,"50M","False","r"
"5541","ECK2832-JW2804","aas",99,2967235,2969371,2136,"50M","False","r"
"5543","ECK2835-JW2805","galR",99,2969961,2970969,1008,"50M","False","f"
"5545","ECK2836-JW2806","lysA",99,2971017,2972256,1239,"50M","False","r"
"5547","ECK2837-JW2807","lysR",99,2972383,2973295,912,"50M","False","f"
"5549","ECK2838-JW2808","ygeA",99,2973323,2973992,669,"50M","False","r"
"5551","ECK2839-JW2809","araE",99,2974144,2975539,1395,"50M","False","r"
"5553","ECK2840-JW2810","kduD",99,2975877,2976615,738,"50M","False","r"
"5555","ECK2841-JW2811","kduI",99,2976668,2977481,813,"50M","False","r"
"5557","ECK2842-JW5453","yqeF",99,2977791,2978949,1158,"50M","False","r"
"5559","ECK2843-JW2813","yqeG",99,2979209,2980415,1206,"50M","False","f"
"5561","ECK2844-JW5454","yqeH",99,2980865,2981507,642,"50M","False","f"
"5563","ECK2845-JW2815","yqeI",99,2981864,2982650,786,"50M","False","f"
"5565","ECK2846-JW5455","yqeJ",99,2982834,2983125,291,"50M","False","f"
"5567","ECK2847-JW2817","yqeK",99,2983315,2983717,402,"50M","False","r"
"5569","ECK2848-JW2818","ygeF",99,2983916,2984339,423,"50M","False","f"
"5571","ECK2849-JW2819","ygeG",99,2984630,2985098,468,"50M","False","f"
"5573","ECK2850-JW2820","ygeH",99,2985456,2986809,1353,"50M","False","f"
"5575","ECK2851-JW5456","ygeI",99,2986970,2987195,225,"50M","False","f"
"5577","ECK2852-JW5457","pbl",99,2987361,2987754,393,"50M","False","f"
"5579","ECK2853-JW5458","ygeK",99,2987840,2988263,423,"50M","False","r"
"5581","ECK2854-JW2824","ygeL",99,2988317,2988449,132,"50M","False","r"
"5583","ECK2855-JW5459","ygeM",99,2988694,2989102,408,"50M","False","r"
"5585","ECK2856-JW5460","ygeN",99,2989128,2989359,231,"50M","False","r"
"5587","ECK2857-JW5846","ygeO",99,2989342,2989744,402,"50M","False","r"
"5589","ECK2858-JW2831","ygeP",99,2991069,2991345,276,"50M","False","r"
"5591","ECK2859-JW5461","ygeQ",99,2991414,2992227,813,"50M","False","r"
"5593","ECK2861-JW2833","ygeR",99,2992516,2993248,732,"50M","False","r"
"5595","ECK2862-JW5462","xdhA",99,2993707,2995942,2235,"50M","False","f"
"5597","ECK2863-JW2835","xdhB",99,2995976,2996831,855,"50M","False","f"
"5599","ECK2864-JW2836","xdhC",99,2996851,2997307,456,"50M","False","f"
"5601","ECK2865-JW2837","ygeV",99,2997388,2999143,1755,"50M","False","r"
"5603","ECK2866-JW5463","ygeW",99,2999624,3000791,1167,"50M","False","f"
"5605","ECK2867-JW2839","ygeX",99,3000872,3002045,1173,"50M","False","f"
"5607","ECK2868-JW2840","ygeY",99,3002126,3003314,1188,"50M","False","f"
"5609","ECK2869-JW2841","hyuA",99,3003390,3004752,1362,"50M","False","f"
"5611","ECK2870-JW2842","yqeA",99,3004823,3005732,909,"50M","False","f"
"5613","ECK2871-JW2843","yqeB",99,3005994,3007596,1602,"50M","False","r"
"5615","ECK2872-JW5464","yqeC",99,3007667,3008414,747,"50M","False","r"
"5617","ECK2873-JW2845","ygfJ",99,3008522,3009077,555,"50M","False","f"
"5619","ECK2874-JW5923","ygfK",99,3010424,3012497,2073,"50M","False","f"
"5621","ECK2875-JW2847","ssnA",99,3012523,3013828,1305,"50M","False","f"
"5623","ECK2876-JW2848","ygfM",99,3013902,3014658,756,"50M","False","f"
"5625","ECK2877-JW2849","xdhD",99,3014678,3017525,2847,"50M","False","f"
"5627","ECK2878-JW2850","ygfO",99,3017713,3019090,1377,"50M","False","f"
"5629","ECK2879-JW5466","guaD",99,3019128,3020424,1296,"50M","False","f"
"5631","ECK2880-JW5467","ygfQ",99,3020483,3021827,1344,"50M","False","f"
"5633","ECK2881-JW5468","ygfS",99,3021904,3022369,465,"50M","False","r"
"5635","ECK2882-JW5469","ygfT",99,3022392,3024288,1896,"50M","False","r"
"5637","ECK2883-JW5470","ygfU",99,3024729,3026154,1425,"50M","False","f"
"5639","none-JW5471","none",99,3026179,3026281,102,"50M","False","f"
"5641","ECK2884-JW2857","idi",99,3026427,3026952,525,"50M","False","f"
"5643","ECK2885-JW2858","lysS",99,3027037,3028531,1494,"50M","False","r"
"5645","ECK2886-JW5847","prfB",99,3028564,3029639,1075,"50M","False","r"
"5647","ECK2887-JW2860","recJ",99,3029753,3031463,1710,"50M","False","r"
"5649","ECK2888-JW2861","dsbC",99,3031492,3032179,687,"50M","False","r"
"5651","ECK2889-JW2862","xerD",99,3032227,3033100,873,"50M","False","r"
"5653","ECK2890-JW2863","fldB",99,3033217,3033715,498,"50M","False","f"
"5655","ECK2891-JW2864","ygfX",99,3033796,3034180,384,"50M","False","r"
"5657","ECK2892-JW2865","ygfY",99,3034184,3034427,243,"50M","False","r"
"5659","ECK2893-JW2866","ygfZ",99,3034675,3035632,957,"50M","False","f"
"5661","ECK2894-JW2867","yqfA",99,3035869,3036505,636,"50M","False","r"
"5663","ECK2895-JW2868","yqfB",99,3036692,3036980,288,"50M","False","r"
"5665","ECK2896-JW2869","bglA",99,3037024,3038440,1416,"50M","False","f"
"5667","ECK2897-JW2870","ygfF",99,3038538,3039258,720,"50M","False","r"
"5669","ECK2898-JW2871","gcvP",99,3039548,3042398,2850,"50M","False","r"
"5671","ECK2899-JW2872","gcvH",99,3042540,3042906,366,"50M","False","r"
"5673","ECK2900-JW2873","gcvT",99,3042953,3044024,1071,"50M","False","r"
"5675","ECK2901-JW2874","visC",99,3044495,3045674,1179,"50M","False","r"
"5677","ECK2902-JW2875","ubiH",99,3045720,3046875,1155,"50M","False","r"
"5679","ECK2903-JW2876","pepP",99,3046895,3048197,1302,"50M","False","r"
"5681","ECK2904-JW5473","ygfB",99,3048246,3048801,555,"50M","False","r"
"5683","ECK2905-JW2878","zapA",99,3048974,3049280,306,"50M","False","f"
"5685","none-JW5474","none",99,3049271,3049574,303,"50M","False","r"
"5687","ECK2907-JW2879","ygfA",99,3049603,3050128,525,"50M","False","f"
"5689","ECK2909-JW2880","serA",99,3050558,3051767,1209,"50M","False","r"
"5691","ECK2910-JW5475","rpiA",99,3052046,3052718,672,"50M","False","r"
"5693","ECK2911-JW2882","yqfE",99,3052761,3052968,207,"50M","False","r"
"5695","ECK2912-JW2883","argP",99,3053115,3053985,870,"50M","False","f"
"5697","ECK2913-JW2884","yliK",99,3054212,3056333,2121,"50M","False","f"
"5699","ECK2914-JW2885","argK",99,3056349,3057321,972,"50M","False","f"
"5701","ECK2915-JW2886","ygfG",99,3057355,3058117,762,"50M","False","f"
"5703","ECK2916-JW2887","ygfH",99,3058164,3059619,1455,"50M","False","f"
"5705","ECK2917-JW5476","ygfI",99,3059657,3060545,888,"50M","False","r"
"5707","ECK2918-JW2889","yggE",99,3060720,3061437,717,"50M","False","r"
"5709","ECK2919-JW2890","argO",99,3061553,3062165,612,"50M","False","r"
"5711","ECK2920-JW2891","mscS",99,3062327,3063164,837,"50M","False","r"
"5713","ECK2921-JW2892","fbaA",99,3063545,3064601,1056,"50M","False","r"
"5715","ECK2922-JW2893","pgk",99,3064839,3065979,1140,"50M","False","r"
"5717","ECK2923-JW2894","epd",99,3066052,3067048,996,"50M","False","r"
"5719","ECK2924-JW2895","yggC",99,3067356,3068046,690,"50M","False","r"
"5721","ECK2925-JW2896","yggD",99,3068066,3068552,486,"50M","False","r"
"5723","ECK2926-JW2897","yggF",99,3068597,3069539,942,"50M","False","r"
"5725","ECK2927-JW5477","yggP",99,3069559,3070813,1254,"50M","False","r"
"5727","ECK2928-JW2900","cmtA",99,3070851,3072216,1365,"50M","False","r"
"5729","ECK2929-JW2901","cmtB",99,3072267,3072687,420,"50M","False","r"
"5731","ECK2930-JW5478","tktA",99,3073023,3074992,1969,"7M1D43M","False","r"
"5733","ECK2931-JW2903","yggG",99,3075275,3076010,735,"50M","False","f"
"5735","ECK2932-JW2904","speB",99,3076257,3077154,897,"50M","False","r"
"5737","ECK2933-JW2905","speA",99,3077315,3079268,1953,"50M","False","r"
"5739","ECK2934-JW2906","yqgB",99,3079300,3079423,123,"50M","False","r"
"5741","ECK2935-JW2907","yqgC",99,3079549,3079741,192,"50M","False","f"
"5743","ECK2936-JW2908","yqgD",99,3079779,3080007,228,"50M","False","r"
"5745","ECK2937-JW2909","metK",99,3080068,3081199,1131,"50M","False","f"
"5747","ECK2938-JW2910","galP",99,3081645,3083017,1372,"10M1D40M","False","f"
"5749","ECK2939-JW2911","sprT",99,3083117,3083591,474,"50M","False","f"
"5751","ECK2940-JW2912","endA",99,3083709,3084393,684,"50M","False","f"
"5753","ECK2941-JW2913","yggJ",99,3084496,3085204,708,"50M","False","f"
"5755","ECK2942-JW2914","gshB",99,3085240,3086167,927,"50M","False","f"
"5757","ECK2943-JW2915","yqgE",99,3086299,3086839,540,"50M","False","f"
"5759","ECK2944-JW2916","yqgF",99,3086862,3087255,393,"50M","False","f"
"5761","ECK2945-JW2917","yggR",99,3087480,3088437,957,"50M","False","r"
"5763","ECK2946-JW2918","yggS",99,3088460,3089141,681,"50M","False","f"
"5765","ECK2947-JW2919","yggT",99,3089182,3089725,543,"50M","False","f"
"5767","ECK2948-JW5479","yggU",99,3089745,3090012,267,"50M","False","f"
"5769","ECK2949-JW2921","yggV",99,3090043,3090613,570,"50M","False","f"
"5771","ECK2950-JW2922","yggW",99,3090629,3091742,1113,"50M","False","f"
"5773","ECK2951-JW2923","yggM",99,3091938,3092922,984,"50M","False","r"
"5775","ECK2952-JW2924","ansB",99,3093062,3094085,1023,"50M","False","r"
"5777","ECK2953-JW2925","yggN",99,3094284,3094980,696,"50M","False","r"
"5779","none-JW5480","none",99,3095024,3095141,117,"50M","False","r"
"5781","ECK2954-JW2926","yggL",99,3095187,3095490,303,"50M","False","r"
"5783","ECK2955-JW2927","yggH",99,3095513,3096209,696,"50M","False","r"
"5785","ECK2956-JW2928","mutY",99,3096375,3097404,1029,"50M","False","f"
"5787","ECK2957-JW2929","yggX",99,3097455,3097707,252,"50M","False","f"
"5789","ECK2958-JW5481","mltC",99,3097792,3098307,515,"50M","False","f"
"5791","ECK2959-JW2932","nupG",99,3099076,3100309,1233,"50M","False","f"
"5793","ECK2960-JW5482","speC",99,3100400,3102512,2112,"50M","False","r"
"5795","ECK2961-JW2934","yqgA",99,3102915,3103599,684,"50M","False","f"
"5797","ECK2963-JW2935","yghD",99,3103970,3104483,513,"50M","False","r"
"5799","ECK2964-JW5924","yghE",99,3104508,3105261,753,"50M","False","r"
"5801","ECK2965-JW5484","yghF",99,3105434,3106277,843,"50M","False","r"
"5803","ECK2966-JW2938","yghG",99,3106447,3106834,387,"50M","False","r"
"5805","ECK2967-JW2939","pppA",99,3106923,3107709,786,"50M","False","r"
"5807","ECK2968-JW5925","yghJ",97,3107930,3112094,4164,"50M","False","r"
"5809","ECK2969-JW2942","yghK",99,3112977,3114636,1659,"50M","False","r"
"5811","ECK2970-JW2943","glcB",99,3115014,3117162,2148,"50M","False","r"
"5813","ECK2971-JW2944","glcG",99,3117207,3117588,381,"50M","False","r"
"5815","ECK2972-JW5486","glcF",99,3117616,3118816,1200,"50M","False","r"
"5817","ECK2973-JW5487","glcE",99,3118850,3119879,1029,"50M","False","r"
"5819","ECK2974-JW2946","glcD",99,3119902,3121378,1476,"50M","False","r"
"5821","ECK2975-JW2947","glcC",99,3121634,3122375,741,"50M","False","f"
"5823","ECK2976-JW5848","yghO",99,3122423,3123536,1113,"50M","False","r"
"5825","ECK2977-JW5490","yghQ",99,3124721,3125765,1044,"50M","False","r"
"5827","ECK2978-JW2952","yghR",99,3125834,3126569,735,"50M","False","r"
"5829","ECK2979-JW5491","yghS",99,3126624,3127314,690,"50M","False","r"
"5831","ECK2980-JW2954","yghT",99,3127493,3128162,669,"50M","False","f"
"5833","ECK2981-JW2955","pitB",99,3128252,3129728,1476,"50M","False","r"
"5835","ECK2982-JW2956","gss",99,3130043,3131879,1836,"50M","False","r"
"5837","ECK2983-JW5492","yghU",99,3132089,3132932,843,"50M","False","f"
"5839","ECK2984-JW2958","hybG",99,3133096,3133321,225,"50M","False","r"
"5841","ECK2985-JW5493","hybF",99,3133357,3133675,318,"50M","False","r"
"5843","ECK2986-JW2960","hybE",99,3133691,3134156,465,"50M","False","r"
"5845","ECK2987-JW2961","hybD",99,3134172,3134643,471,"50M","False","r"
"5847","ECK2988-JW2962","hybC",99,3134666,3136346,1680,"50M","False","r"
"5849","ECK2989-JW5494","hybB",99,3136366,3137521,1155,"50M","False","r"
"5851","ECK2990-JW2964","hybA",99,3137534,3138497,963,"50M","False","r"
"5853","ECK2991-JW2965","hybO",99,3138523,3139618,1095,"50M","False","r"
"5855","ECK2992-JW2966","yghW",99,3139830,3140094,264,"50M","False","r"
"5857","ECK2993-JW5926","yghX",99,3140236,3140593,357,"50M","False","r"
"5859","ECK2994-JW5496","yghY",99,3140646,3140976,330,"50M","False","r"
"5861","none-JW5497","none",99,3140977,3141097,120,"50M","False","r"
"5863","ECK2995-JW2970","yghZ",99,3141259,3142276,1017,"50M","False","f"
"5865","ECK2996-JW2971","yqhA",99,3142357,3142828,471,"50M","False","r"
"5867","ECK2997-JW2972","yghA",99,3143024,3143885,861,"50M","False","f"
"5869","ECK2998-JW2973","exbD",99,3144198,3144600,402,"50M","False","r"
"5871","ECK2999-JW2974","exbB",99,3144630,3145341,711,"50M","False","r"
"5873","ECK3000-JW2975","metC",99,3145598,3146762,1164,"50M","False","f"
"5875","ECK3001-JW2976","yghB",99,3146925,3147561,636,"50M","False","f"
"5877","ECK3002-JW5849","yqhC",99,3147642,3148746,1104,"50M","False","r"
"5879","ECK3003-JW2978","yqhD",99,3148717,3149857,1140,"50M","False","f"
"5881","ECK3004-JW5499","dkgA",99,3149985,3150789,804,"50M","False","f"
"5883","ECK3005-JW5500","yqhG",99,3151012,3151915,903,"50M","False","f"
"5885","ECK3006-JW2982","yqhH",99,3151989,3152223,234,"50M","False","f"
"5887","ECK3007-JW5501","ygiQ",99,3152307,3154503,2196,"50M","False","r"
"5889","ECK3008-JW2985","sufI",99,3154637,3156026,1389,"50M","False","r"
"5891","ECK3009-JW2986","plsC",99,3156124,3156838,714,"50M","False","r"
"5893","ECK3010-JW2987","parC",99,3157095,3159330,2235,"50M","False","r"
"5895","ECK3011-JW2988","ygiS",99,3159491,3161075,1584,"50M","False","r"
"5897","ECK3012-JW2989","ygiT",99,3161231,3161603,372,"50M","False","r"
"5899","ECK3013-JW2990","ygiU",99,3161628,3161901,273,"50M","False","r"
"5901","ECK3014-JW5502","ygiV",99,3162129,3162588,459,"50M","False","r"
"5903","ECK3015-JW2992","ygiW",99,3162664,3163033,369,"50M","False","r"
"5905","ECK3016-JW2993","qseB",99,3163190,3163826,636,"50M","False","f"
"5907","ECK3017-JW2994","qseC",99,3163846,3165172,1326,"50M","False","f"
"5909","ECK3018-JW2995","ygiZ",99,3165259,3165568,309,"50M","False","r"
"5911","ECK3019-JW2996","mdaB",99,3165892,3166450,558,"50M","False","f"
"5913","ECK3020-JW2997","ygiN",99,3166504,3166795,291,"50M","False","f"
"5915","ECK3021-JW2998","parE",99,3166884,3168753,1869,"50M","False","r"
"5917","ECK3022-JW2999","yqiA",99,3168805,3169363,558,"50M","False","r"
"5919","ECK3023-JW3000","cpdA",99,3169386,3170190,804,"50M","False","r"
"5921","ECK3024-JW3001","yqiB",99,3170238,3170637,399,"50M","False","r"
"5923","ECK3025-JW3002","nudF",99,3170661,3171267,606,"50M","False","r"
"5925","ECK3026-JW5503","tolC",99,3171471,3172935,1464,"50M","False","f"
"5927","ECK3028-JW5927","ygiB",99,3173106,3173754,648,"50M","False","f"
"5929","ECK3029-JW3006","ygiC",99,3173783,3174920,1137,"50M","False","f"
"5931","ECK3030-JW3007","zupT",99,3174999,3175791,792,"50M","False","r"
"5933","ECK3031-JW3008","ygiE",99,3175912,3176662,750,"50M","False","f"
"5935","ECK3032-JW3009","ribB",99,3177193,3177823,630,"50M","False","r"
"5937","ECK3033-JW5505","yqiC",99,3178202,3178469,267,"50M","False","f"
"5939","ECK3034-JW3011","ygiL",99,3178776,3179304,528,"50M","False","f"
"5941","ECK3035-JW5507","yqiG",99,3180762,3181682,920,"50M","False","f"
"5943","ECK3036-JW5508","yqiH",99,3183243,3183969,726,"50M","False","f"
"5945","ECK3037-JW5509","yqiI",99,3183994,3185035,1041,"50M","False","f"
"5947","ECK3038-JW3021","glgS",99,3185119,3185296,177,"50M","False","r"
"5949","ECK3039-JW3022","yqiJ",99,3185570,3186176,606,"50M","False","f"
"5951","ECK3040-JW3023","yqiK",99,3186226,3187864,1638,"50M","False","f"
"5953","ECK3042-JW3024","rfaE",99,3188700,3190110,1410,"50M","False","r"
"5955","ECK3043-JW3025","glnE",99,3190181,3192998,2817,"50M","False","r"
"5957","ECK3044-JW3026","ygiF",99,3193044,3194322,1278,"50M","False","r"
"5959","ECK3045-JW3027","htrG",99,3194569,3195166,597,"50M","False","f"
"5961","ECK3046-JW3028","cca",99,3195253,3196468,1215,"50M","False","f"
"5963","ECK3047-JW3029","bacA",99,3196690,3197488,798,"50M","False","r"
"5965","ECK3048-JW3030","folB",99,3197601,3197946,345,"50M","False","r"
"5967","ECK3049-JW3031","ygiH",99,3198056,3198650,594,"50M","False","f"
"5969","ECK3050-JW3032","ygiP",99,3198704,3199613,909,"50M","False","r"
"5971","ECK3051-JW3033","ttdA",99,3199825,3200713,888,"50M","False","f"
"5973","ECK3052-JW3034","ttdB",99,3200733,3201315,582,"50M","False","f"
"5975","ECK3053-JW3035","ygjE",99,3201386,3202826,1440,"50M","False","f"
"5977","ECK3054-JW3036","ygjD",99,3202910,3203900,990,"50M","False","r"
"5979","ECK3055-JW3037","rpsU",99,3204143,3204335,192,"50M","False","f"
"5981","ECK3056-JW3038","dnaG",99,3204469,3206191,1722,"50M","False","f"
"5983","ECK3057-JW3039","rpoD",99,3206409,3208227,1818,"50M","False","f"
"5985","ECK3058-JW3040","ygjF",99,3208347,3208830,483,"50M","False","r"
"5987","ECK3060-JW3041","yqjH",99,3209107,3209848,741,"50M","False","r"
"5989","ECK3061-JW3042","yqjI",99,3210141,3210741,600,"50M","False","f"
"5991","ECK3062-JW3043","aer",99,3210936,3212433,1497,"50M","False","r"
"5993","ECK3063-JW5510","ygjG",99,3212829,3214212,1383,"50M","False","f"
"5995","ECK3064-JW3045","ygjH",99,3214295,3214604,309,"50M","False","r"
"5997","ECK3065-JW3046","ebgR",99,3214828,3215788,960,"50M","False","f"
"5999","ECK3066-JW5511","ebgA",99,3215995,3219064,3069,"50M","False","f"
"6001","ECK3067-JW3048","ebgC",99,3219084,3219510,426,"50M","False","f"
"6003","ECK3068-JW5512","ygjI",99,3219596,3221006,1410,"50M","False","f"
"6005","ECK3069-JW3050","ygjJ",99,3221163,3222210,1047,"50M","False","f"
"6007","ECK3070-JW3051","ygjK",99,3222250,3224578,2328,"50M","False","f"
"6009","ECK3071-JW3052","fadH",99,3225027,3227022,1995,"50M","False","f"
"6011","ECK3072-JW3053","ygjM",99,3227108,3227501,393,"50M","False","r"
"6013","ECK3073-JW3054","ygjN",99,3227521,3227812,291,"50M","False","r"
"6015","ECK3074-JW5513","ygjO",99,3228119,3229232,1113,"50M","False","r"
"6017","ECK3075-JW5514","ygjP",99,3229322,3229802,480,"50M","False","f"
"6019","ECK3076-JW3057","ygjQ",99,3229902,3230571,669,"50M","False","f"
"6021","ECK3077-JW3058","ygjR",99,3230655,3231636,981,"50M","False","f"
"6023","ECK3079-JW5515","alx",99,3231942,3232884,942,"50M","False","f"
"6025","ECK3080-JW3060","sstT",99,3233306,3234527,1221,"50M","False","f"
"6027","ECK3081-JW3061","ygjV",99,3234573,3235101,528,"50M","False","r"
"6029","ECK3082-JW3062","uxaA",99,3235207,3236671,1464,"50M","False","r"
"6031","ECK3083-JW3063","uxaC",99,3236709,3238098,1389,"50M","False","r"
"6033","ECK3084-JW3064","exuT",99,3238466,3239861,1395,"50M","False","f"
"6035","ECK3085-JW3065","exuR",99,3240014,3240767,753,"50M","False","f"
"6037","ECK3086-JW3066","yqjA",99,3241135,3241774,639,"50M","False","f"
"6039","ECK3087-JW3067","yqjB",99,3241801,3242161,360,"50M","False","f"
"6041","ECK3088-JW5516","yqjC",99,3242331,3242676,345,"50M","False","f"
"6043","ECK3089-JW3069","yqjD",99,3242737,3243019,282,"50M","False","f"
"6045","ECK3090-JW3070","yqjE",99,3243045,3243426,381,"50M","False","f"
"6047","ECK3091-JW3071","yqjK",99,3243439,3243715,276,"50M","False","f"
"6049","ECK3092-JW5850","yqjF",99,3243834,3244293,459,"50M","False","f"
"6051","ECK3093-JW3073","yqjG",99,3244386,3245349,963,"50M","False","f"
"6053","ECK3094-JW3074","yhaH",99,3245666,3246008,342,"50M","False","f"
"6055","ECK3095-JW3075","yhaI",99,3246273,3246606,333,"50M","False","f"
"6057","ECK3096-JW3076","yhaJ",99,3246698,3247571,873,"50M","False","r"
"6059","ECK3097-JW3077","yhaK",99,3247681,3248359,678,"50M","False","f"
"6061","ECK3098-JW5517","yhaL",99,3248405,3248546,141,"50M","False","f"
"6063","ECK3099-JW5518","yhaM",99,3248721,3250008,1287,"50M","False","r"
"6065","ECK3100-JW5519","yhaO",99,3250059,3251304,1245,"50M","False","r"
"6067","ECK3101-JW5520","tdcG",99,3251665,3253006,1341,"50M","False","r"
"6069","ECK3102-JW5521","tdcF",99,3253101,3253467,366,"50M","False","r"
"6071","ECK3103-JW5522","tdcE",99,3253504,3255775,2271,"50M","False","r"
"6073","ECK3104-JW5806","tdcD",99,3255832,3257017,1185,"50M","False","r"
"6075","ECK3105-JW3087","tdcC",99,3257066,3258374,1308,"50M","False","r"
"6077","ECK3106-JW3088","tdcB",99,3258419,3259385,966,"50M","False","r"
"6079","ECK3107-JW3089","tdcA",99,3259507,3260422,915,"50M","False","r"
"6081","ECK3108-JW5525","tdcR",99,3260742,3260937,195,"50M","False","f"
"6083","ECK3109-JW3091","yhaB",99,3261216,3261732,516,"50M","False","f"
"6085","ECK3110-JW3092","yhaC",99,3261777,3262941,1164,"50M","False","f"
"6087","ECK3112-JW3093","garK",99,3264005,3265208,1203,"50M","False","r"
"6089","ECK3113-JW5526","garR",99,3265247,3266114,867,"50M","False","r"
"6091","ECK3114-JW3095","garL",99,3266167,3266914,747,"50M","False","r"
"6093","ECK3115-JW3096","garP",99,3266953,3268264,1311,"50M","False","r"
"6095","ECK3116-JW3097","garD",99,3268644,3270192,1548,"50M","False","f"
"6097","ECK3117-JW3098","sohA",99,3270364,3270676,312,"50M","False","f"
"6099","ECK3118-JW3099","yhaV",99,3270699,3271140,441,"50M","False","f"
"6101","ECK3119-JW3100","agaR",99,3271236,3272022,786,"50M","False","r"
"6103","ECK3120-JW3101","kbaZ",99,3272276,3273533,1257,"50M","False","f"
"6105","ECK3121-JW3102","agaV",99,3273579,3274029,450,"50M","False","f"
"6107","ECK3122-JW3103","agaW",99,3274063,3274441,378,"50M","False","f"
"6109","ECK3123-JW5527","agaA",99,3274484,3274964,480,"50M","False","f"
"6111","ECK3124-JW3105","agaS",99,3275338,3276469,1131,"50M","False","f"
"6113","ECK3125-JW3106","kbaY",99,3276505,3277342,837,"50M","False","f"
"6115","ECK3126-JW3107","agaB",99,3277532,3277985,453,"50M","False","f"
"6117","ECK3127-JW3108","agaC",99,3278047,3278827,780,"50M","False","f"
"6119","ECK3128-JW3109","agaD",99,3278840,3279608,768,"50M","False","f"
"6121","ECK3129-JW3110","agaI",99,3279632,3280364,732,"50M","False","f"
"6123","ECK3130-JW3111","yraH",99,3280788,3281349,561,"50M","False","f"
"6125","ECK3131-JW3112","yraI",99,3281452,3282124,672,"50M","False","f"
"6127","ECK3132-JW3113","yraJ",99,3282176,3284669,2493,"50M","False","f"
"6129","ECK3133-JW3114","yraK",99,3284703,3285771,1068,"50M","False","f"
"6131","ECK3134-JW3115","yraL",99,3285855,3286692,837,"50M","False","r"
"6133","ECK3135-JW3116","yraM",99,3286762,3288775,2013,"50M","False","f"
"6135","ECK3136-JW3117","yraN",99,3288756,3289128,372,"50M","False","f"
"6137","ECK3137-JW3118","yraO",99,3289171,3289738,567,"50M","False","f"
"6139","ECK3138-JW3119","yraP",99,3289771,3290323,552,"50M","False","f"
"6141","ECK3139-JW3120","yraQ",99,3290478,3291495,1017,"50M","False","r"
"6143","ECK3140-JW5528","yraR",99,3291591,3292203,612,"50M","False","r"
"6145","ECK3141-JW5529","yhbO",99,3292294,3292831,537,"50M","False","f"
"6147","ECK3142-JW3123","yhbP",99,3292852,3293272,420,"50M","False","r"
"6149","ECK3143-JW3124","yhbQ",99,3293328,3293607,279,"50M","False","f"
"6151","ECK3144-JW3125","yhbS",99,3293635,3294115,480,"50M","False","r"
"6153","ECK3145-JW3126","yhbT",99,3294132,3294633,501,"50M","False","r"
"6155","ECK3146-JW3127","yhbU",99,3294847,3295819,972,"50M","False","f"
"6157","ECK3147-JW5530","yhbV",99,3295851,3296706,855,"50M","False","f"
"6159","ECK3148-JW3129","yhbW",99,3296810,3297794,984,"50M","False","f"
"6161","ECK3149-JW3130","mtr",99,3297953,3299174,1221,"50M","False","r"
"6163","ECK3150-JW5531","deaD",99,3299351,3301268,1917,"50M","False","r"
"6165","ECK3151-JW3132","nlpI",99,3301420,3302281,861,"50M","False","r"
"6167","ECK3152-JW5851","pnp",99,3302413,3304525,2112,"50M","False","r"
"6169","ECK3154-JW3134","rpsO",99,3304795,3305041,246,"50M","False","r"
"6171","ECK3155-JW3135","truB",99,3305213,3306134,921,"50M","False","r"
"6173","ECK3156-JW3136","rbfA",99,3306157,3306535,378,"50M","False","r"
"6175","ECK3157-JW3137","infB",99,3306722,3309371,2649,"50M","False","r"
"6177","ECK3158-JW3138","nusA",99,3309419,3310883,1464,"50M","False","r"
"6179","ECK3159-JW5533","yhbC",99,3310934,3311363,429,"50M","False","r"
"6181","ECK3161-JW3140","argG",99,3311999,3313319,1320,"50M","False","f"
"6183","ECK3162-JW5534","yhbX",99,3313368,3314970,1602,"50M","False","r"
"6185","ECK3164-JW3142","secG",99,3315553,3315862,309,"50M","False","r"
"6187","ECK3165-JW3143","glmM",99,3316113,3317427,1314,"50M","False","r"
"6189","ECK3166-JW3144","folP",99,3317443,3318268,825,"50M","False","r"
"6191","ECK3167-JW3145","ftsH",99,3318381,3320292,1911,"50M","False","r"
"6193","ECK3168-JW3146","rrmJ",99,3320415,3321021,606,"50M","False","r"
"6195","ECK3169-JW3147","yhbY",99,3321152,3321422,270,"50M","False","f"
"6197","ECK3170-JW3148","greA",99,3321619,3322072,453,"50M","False","r"
"6199","ECK3171-JW3149","dacB",99,3322325,3323735,1410,"50M","False","f"
"6201","ECK3172-JW3150","obgE",99,3323962,3325111,1149,"50M","False","r"
"6203","ECK3173-JW3151","yhbE",99,3325150,3326092,942,"50M","False","r"
"6205","ECK3174-JW3152","rpmA",99,3326242,3326476,234,"50M","False","r"
"6207","ECK3175-JW3153","rplU",99,3326520,3326808,288,"50M","False","r"
"6209","ECK3176-JW3154","ispB",99,3327072,3328020,948,"50M","False","f"
"6211","ECK3177-JW3155","sfsB",99,3328271,3328526,255,"50M","False","f"
"6213","ECK3178-JW3156","murA",99,3328615,3329851,1236,"50M","False","r"
"6215","ECK3179-JW3157","yrbA",99,3329929,3330160,231,"50M","False","r"
"6217","ECK3180-JW5535","yrbB",99,3330343,3330613,270,"50M","False","r"
"6219","ECK3181-JW3159","yrbC",99,3330636,3331248,612,"50M","False","r"
"6221","ECK3182-JW3160","yrbD",99,3331290,3331818,528,"50M","False","r"
"6223","ECK3183-JW3161","yrbE",99,3331846,3332605,759,"50M","False","r"
"6225","ECK3184-JW3162","yrbF",99,3332636,3333422,786,"50M","False","r"
"6227","ECK3185-JW3163","yrbG",99,3333637,3334591,954,"50M","False","f"
"6229","ECK3186-JW3164","kdsD",99,3334628,3335591,963,"50M","False","f"
"6231","ECK3187-JW3165","kdsC",99,3335635,3336178,543,"50M","False","f"
"6233","ECK3188-JW3166","yrbK",99,3336198,3336750,552,"50M","False","f"
"6235","ECK3189-JW3167","yhbN",99,3336772,3337276,504,"50M","False","f"
"6237","ECK3190-JW3168","yhbG",99,3337306,3338008,702,"50M","False","f"
"6239","ECK3191-JW3169","rpoN",99,3338079,3339489,1410,"50M","False","f"
"6241","ECK3192-JW3170","yhbH",99,3339535,3339799,264,"50M","False","f"
"6243","ECK3193-JW3171","ptsN",99,3339940,3340408,468,"50M","False","f"
"6245","ECK3194-JW3172","yhbJ",99,3340477,3341308,831,"50M","False","f"
"6247","ECK3195-JW3173","npr",99,3341328,3341577,249,"50M","False","f"
"6249","ECK3196-JW3174","yrbL",99,3341814,3342423,609,"50M","False","f"
"6251","ECK3197-JW3175","mtgA",99,3342461,3343166,705,"50M","False","r"
"6253","ECK3198-JW3176","elbB",99,3343186,3343816,630,"50M","False","r"
"6255","ECK3200-JW5536","arcB",99,3344069,3346382,2313,"50M","False","r"
"6257","ECK3201-JW3178","yhcC",99,3346501,3347407,906,"50M","False","r"
"6259","ECK3202-JW3179","gltB",97,3347994,3352524,4530,"50M","False","f"
"6261","ECK3203-JW3180","gltD",99,3352560,3353955,1395,"50M","False","f"
"6263","ECK3204-JW3181","gltF",99,3354538,3355279,741,"50M","False","f"
"6265","ECK3205-JW3182","yhcA",99,3355474,3356125,651,"50M","False","f"
"6267","ECK3206-JW3183","yhcD",99,3356169,3358527,2358,"50M","False","f"
"6269","ECK3207-JW3184","yhcE",99,3358547,3359003,456,"50M","False","f"
"6271","ECK3207-JW3187","yhcE",99,3360043,3360268,225,"50M","False","f"
"6273","ECK3208-JW3188","yhcF",99,3360288,3360981,693,"50M","False","f"
"6275","ECK3209-JW3189","yhcG",99,3361189,3362293,1104,"50M","False","f"
"6277","ECK3210-JW3190","yhcH",99,3362394,3362835,441,"50M","False","r"
"6279","ECK3211-JW5538","nanK",99,3362855,3363707,852,"50M","False","r"
"6281","ECK3212-JW3192","nanE",99,3363727,3364393,666,"50M","False","r"
"6283","ECK3213-JW3193","nanT",99,3364464,3365931,1467,"50M","False","r"
"6285","ECK3214-JW3194","nanA",99,3366063,3366933,870,"50M","False","r"
"6287","ECK3215-JW3195","nanR",99,3367078,3367846,768,"50M","False","r"
"6289","ECK3216-JW3196","dcuD",99,3368231,3369575,1344,"50M","False","f"
"6291","ECK3217-JW3197","sspB",99,3369659,3370133,474,"50M","False","r"
"6293","ECK3218-JW3198","sspA",99,3370162,3370777,615,"50M","False","r"
"6295","ECK3219-JW3199","rpsI",99,3371195,3371564,369,"50M","False","r"
"6297","ECK3220-JW3200","rplM",99,3371603,3372008,405,"50M","False","r"
"6299","ECK3221-JW3201","yhcM",99,3372250,3373354,1104,"50M","False","r"
"6301","ECK3222-JW5539","yhcB",99,3373553,3373928,375,"50M","False","f"
"6303","ECK3223-JW3203","degQ",99,3374105,3375449,1344,"50M","False","f"
"6305","ECK3224-JW3204","degS",99,3375562,3376606,1044,"50M","False","f"
"6307","ECK3225-JW3205","mdh",99,3376710,3377625,915,"50M","False","r"
"6309","ECK3226-JW3206","argR",99,3378065,3378512,447,"50M","False","f"
"6311","ECK3227-JW5540","yhcN",99,3378900,3379140,240,"50M","False","f"
"6313","ECK3228-JW3208","yhcO",99,3379237,3379486,249,"50M","False","r"
"6315","ECK3229-JW3209","aaeB",99,3379601,3381545,1944,"50M","False","r"
"6317","ECK3230-JW3210","aaeA",99,3381574,3382483,909,"50M","False","r"
"6319","ECK3231-JW5541","aaeX",99,3382514,3382694,180,"50M","False","r"
"6321","ECK3232-JW3212","aaeR",99,3382882,3383788,906,"50M","False","f"
"6323","ECK3233-JW3213","tldD",99,3383963,3385385,1422,"50M","False","r"
"6325","ECK3234-JW5542","yhdP",99,3385838,3388775,2937,"50M","False","r"
"6327","ECK3235-JW3216","rng",99,3389706,3391152,1446,"50M","False","r"
"6329","ECK3236-JW3217","yhdE",99,3391165,3391735,570,"50M","False","r"
"6331","ECK3237-JW3218","mreD",99,3391767,3392232,465,"50M","False","r"
"6333","ECK3238-JW3219","mreC",99,3392255,3393335,1080,"50M","False","r"
"6335","ECK3239-JW3220","mreB",99,3393424,3394444,1020,"50M","False","r"
"6337","ECK3240-JW3221","yhdA",99,3394772,3396689,1917,"50M","False","r"
"6339","ECK3241-JW3222","yhdH",99,3396846,3397797,951,"50M","False","f"
"6341","ECK3242-JW3223","accB",99,3398798,3399245,447,"50M","False","f"
"6343","ECK3243-JW3224","accC",99,3399279,3400605,1326,"50M","False","f"
"6345","ECK3244-JW3225","yhdT",99,3400737,3400956,219,"50M","False","f"
"6347","ECK3245-JW3226","panF",99,3400969,3402397,1428,"50M","False","f"
"6349","ECK3246-JW3227","prmA",99,3402432,3403290,858,"50M","False","f"
"6351","ECK3247-JW3228","dusB",99,3403642,3404584,942,"50M","False","f"
"6353","ECK3248-JW3229","fis",99,3404633,3404906,273,"50M","False","f"
"6355","ECK3249-JW5543","yhdJ",99,3405015,3405876,861,"50M","False","f"
"6357","ECK3250-JW3231","yhdU",99,3405983,3406139,156,"50M","False","f"
"6359","ECK3251-JW3232","envR",99,3406183,3406822,639,"50M","False","r"
"6361","ECK3252-JW3233","acrE",99,3407226,3408360,1134,"50M","False","f"
"6363","ECK3253-JW3234","acrF",99,3408395,3411476,3081,"50M","False","f"
"6365","ECK3254-JW3235","yhdV",99,3411752,3411950,198,"50M","False","f"
"6367","ECK3255-JW3236","yhdW",99,3412511,3413405,894,"50M","False","f"
"6369","ECK3256-JW5544","yhdX",99,3413496,3414654,1158,"50M","False","f"
"6371","ECK3257-JW5545","yhdY",99,3414687,3415767,1080,"50M","False","f"
"6373","ECK3258-JW3239","yhdZ",99,3415798,3416533,735,"50M","False","f"
"6376","ECK3998-JW3970","purH",163,4195842,4197508,1666,"50M","False","f"
"6378","ECK3997-JW3969","purD",163,4194541,4195907,1366,"50M","False","f"
"6380","ECK3996-JW3968","zraR",163,4193201,4194603,1402,"50M","False","r"
"6382","ECK3995-JW3967","zraS",163,4191807,4193281,1474,"50M","False","r"
"6384","ECK3994-JW5546","zraP",163,4191162,4191664,502,"50M","False","f"
"6386","ECK3993-JW3965","yjaH",163,4190447,4191219,772,"50M","False","r"
"6388","ECK3992-JW3964","hupA",163,4190162,4190511,349,"50M","False","r"
"6390","ECK3991-JW3963","yjaG",163,4189385,4190052,667,"50M","False","r"
"6392","ECK3990-JW5547","nfi",163,4188671,4189419,748,"50M","False","r"
"6394","ECK3989-JW3961","hemE",163,4187597,4188738,1141,"50M","False","r"
"6396","ECK3988-JW5548","nudC",163,4186784,4187634,850,"50M","False","r"
"6398","ECK3987-JW3959","rsd",163,4186234,4186784,550,"50M","False","f"
"6400","ECK3986-JW3958","thiC",163,4184103,4186075,1972,"50M","False","f"
"6402","ECK3985-JW3957","thiE",163,4183468,4184180,712,"50M","False","f"
"6404","ECK3984-JW3956","thiF",163,4182720,4183552,832,"50M","False","f"
"6406","ECK3983-JW3955","thiS",163,4182536,4182813,277,"50M","False","f"
"6408","ECK3982-JW5549","thiG",163,4181764,4182611,847,"50M","False","f"
"6410","ECK3981-JW3953","thiH",163,4180634,4181844,1210,"50M","False","f"
"6412","ECK3980-JW3952","htrC",163,4179667,4180283,616,"50M","False","r"
"6414","ECK3979-JW3951","rpoC",161,4175231,4179531,4300,"50M","False","r"
"6416","ECK3978-JW3950","rpoB",161,4171126,4175231,4105,"50M","False","r"
"6418","ECK3977-JW3949","rplL",163,4170441,4170883,442,"50M","False","r"
"6420","ECK3976-JW3948","rplJ",163,4169877,4170451,574,"50M","False","r"
"6422","ECK3975-JW3947","rplA",163,4168760,4169541,781,"50M","False","r"
"6424","ECK3974-JW3946","rplK",163,4168328,4168833,505,"50M","False","r"
"6426","ECK3973-JW3945","nusG",163,4167624,4168246,622,"50M","False","r"
"6428","ECK3972-JW3944","secE",163,4167239,4167699,460,"50M","False","r"
"6430","ECK3971-JW3943","tufB",163,4165825,4167086,1261,"50M","False","r"
"6432","ECK3966-JW3942","coaA",163,4163975,4165002,1027,"50M","False","f"
"6434","ECK3965-JW3941","birA",163,4162966,4164005,1039,"50M","False","r"
"6436","ECK3964-JW3940","murB",163,4161938,4163043,1105,"50M","False","r"
"6438","ECK3959-JW5550","murI",163,4155309,4156243,934,"50M","False","r"
"6440","ECK3958-JW3938","btuB",163,4153520,4155441,1921,"50M","False","r"
"6442","ECK3957-JW3937","trmA",163,4152069,4153246,1177,"50M","False","f"
"6444","ECK3956-JW3936","yijD",163,4151652,4152088,436,"50M","False","r"
"6446","ECK3955-JW3935","fabR",163,4150948,4151729,781,"50M","False","r"
"6448","ECK3954-JW5551","sthA",163,4149289,4150766,1477,"50M","False","f"
"6450","ECK3953-JW3933","oxyR",163,4148371,4149365,994,"50M","False","r"
"6452","none-JW5552","none",163,4148115,4148296,181,"50M","False","r"
"6454","ECK3951-JW3932","argH",163,4146731,4148181,1450,"50M","False","r"
"6456","ECK3950-JW5553","argB",163,4145897,4146747,850,"50M","False","r"
"6458","ECK3949-JW3930","argC",163,4144882,4145963,1081,"50M","False","r"
"6460","ECK3948-JW3929","argE",163,4143595,4144823,1228,"50M","False","f"
"6462","none-JW5554","none",163,4143215,4143594,379,"50M","False","f"
"6464","ECK3947-JW3928","ppc",163,4140346,4143074,2728,"50M","False","f"
"6466","ECK3946-JW3927","yijP",163,4138431,4140241,1810,"50M","False","f"
"6468","ECK3945-JW3926","yijO",163,4137365,4138293,928,"50M","False","f"
"6470","ECK3944-JW3925","frwD",163,4137019,4137437,418,"50M","False","r"
"6472","ECK3943-JW3924","pflC",163,4136139,4137094,955,"50M","False","r"
"6474","ECK3942-JW3923","pflD",163,4133876,4136250,2374,"50M","False","r"
"6476","ECK3941-JW3922","frwB",163,4133505,4133902,397,"50M","False","r"
"6478","ECK3940-JW3921","frwC",163,4132411,4133567,1156,"50M","False","r"
"6480","ECK3939-JW5555","ptsA",163,4129619,4132197,2578,"50M","False","f"
"6482","ECK3938-JW3918","fsaB",163,4128945,4129684,739,"50M","False","f"
"6484","ECK3937-JW5556","gldA",163,4127831,4129011,1180,"50M","False","f"
"6486","ECK3936-JW3916","yijF",163,4126939,4127633,694,"50M","False","f"
"6488","ECK3935-JW5557","yijE",163,4125989,4126971,982,"50M","False","r"
"6490","ECK3934-JW3914","katG",163,4123716,4125973,2257,"50M","False","r"
"6492","ECK3933-JW3913","metF",163,4122497,4123464,967,"50M","False","r"
"6494","ECK3932-JW3911","metL",163,4119716,4122225,2509,"50M","False","r"
"6496","ECK3931-JW3910","metB",163,4118553,4119790,1237,"50M","False","r"
"6498","ECK3930-JW3909","metJ",163,4117977,4118371,394,"50M","False","f"
"6500","ECK3929-JW3908","yiiX",163,4117185,4117870,685,"50M","False","f"
"6502","ECK3928-JW3907","rpmE",163,4116894,4117183,289,"50M","False","r"
"6504","ECK3927-JW3906","priA",163,4114511,4116786,2275,"50M","False","f"
"6506","ECK3926-JW3905","cytR",163,4113330,4114432,1102,"50M","False","f"
"6508","ECK3925-JW3904","ftsN",163,4112279,4113315,1036,"50M","False","f"
"6510","ECK3924-JW3903","hslV",163,4111656,4112263,607,"50M","False","f"
"6512","ECK3923-JW3902","hslU",163,4110315,4111723,1408,"50M","False","f"
"6514","ECK3922-JW3901","menA",163,4109322,4110325,1003,"50M","False","f"
"6516","ECK3921-JW3900","rraA",163,4108744,4109306,562,"50M","False","f"
"6518","ECK3920-JW3899","yiiU",163,4108396,4108718,322,"50M","False","r"
"6520","ECK3919-JW3898","glpF",163,4107144,4108066,922,"50M","False","f"
"6522","ECK3918-JW3897","glpK",163,4105613,4107198,1585,"50M","False","f"
"6524","ECK3917-JW3896","glpX",163,4104468,4105555,1087,"50M","False","f"
"6526","ECK3916-JW3895","fpr",163,4103625,4104448,823,"50M","False","f"
"6528","ECK3915-JW3894","yiiT",163,4103174,4103679,505,"50M","False","r"
"6530","ECK3914-JW3893","yiiS",163,4102848,4103224,376,"50M","False","r"
"6532","ECK3913-JW3892","yiiR",163,4102196,4102713,517,"50M","False","r"
"6534","ECK3912-JW3891","yiiQ",163,4101514,4102190,676,"50M","False","f"
"6536","ECK3911-JW3890","tpiA",163,4100639,4101483,844,"50M","False","f"
"6538","ECK3910-JW3889","cdh",163,4099811,4100643,832,"50M","False","r"
"6540","ECK3909-JW3888","sbp",163,4098715,4099781,1066,"50M","False","r"
"6542","ECK3908-JW3887","pfkA",163,4097433,4098472,1039,"50M","False","r"
"6544","ECK3907-JW3886","fieF",163,4096350,4097329,979,"50M","False","r"
"6546","ECK3906-JW5558","cpxP",163,4095701,4096278,577,"50M","False","r"
"6548","ECK3905-JW3883","cpxR",163,4094871,4095646,775,"50M","False","f"
"6550","ECK3904-JW3882","cpxA",163,4093501,4094951,1450,"50M","False","f"
"6552","ECK3903-JW5559","yiiM",163,4092703,4093454,751,"50M","False","r"
"6554","ECK3902-JW5560","kdgT",163,4091571,4092631,1060,"50M","False","r"
"6556","ECK3901-JW3879","sodA",163,4090691,4091388,697,"50M","False","r"
"6558","ECK3900-JW3878","rhaT",163,4089390,4090501,1111,"50M","False","f"
"6560","ECK3899-JW3877","rhaR",163,4088437,4089452,1015,"50M","False","r"
"6562","ECK3898-JW3876","rhaS",163,4087617,4088530,913,"50M","False","r"
"6564","ECK3894-JW3872","yiiL",163,4086455,4086846,391,"50M","False","f"
"6566","ECK3893-JW3871","frvA",163,4085708,4086231,523,"50M","False","f"
"6568","ECK3892-JW5562","frvB",163,4084246,4085774,1528,"50M","False","f"
"6570","ECK3891-JW3869","frvX",163,4083186,4084333,1147,"50M","False","f"
"6572","ECK3890-JW3868","frvR",163,4081439,4083263,1824,"16M1I33M","False","f"
"6574","ECK3889-JW3867","yiiG",163,4080315,4081447,1132,"50M","False","r"
"6576","ECK3888-JW3866","fdhD",163,4079329,4080239,910,"50M","False","r"
"6578","ECK3887-JW3865","fdoG",163,4076103,4079230,3127,"50M","False","f"
"6580","ECK3886-JW3864","fdoH",163,4075188,4076167,979,"50M","False","f"
"6582","ECK3885-JW3863","fdoI",163,4074556,4075268,712,"50M","False","f"
"6584","ECK3884-JW3862","fdhE",163,4073630,4074636,1006,"50M","False","f"
"6586","ECK3883-JW5563","yiiF",163,4073064,4073359,295,"50M","False","r"
"6588","ECK3882-JW5929","yiiE",163,4072610,4072899,289,"50M","False","r"
"6590","none-JW5565","none",163,4072162,4072346,184,"50M","False","r"
"6592","ECK3881-JW3859","yiiD",163,4070762,4071828,1066,"50M","False","r"
"6594","ECK3880-JW3858","dtd",163,4070328,4070842,514,"50M","False","r"
"6596","ECK3879-JW3857","rbn",163,4069459,4070408,949,"50M","False","r"
"6598","ECK3878-JW5566","yihX",163,4068866,4069542,676,"50M","False","r"
"6600","ECK3877-JW5567","yihW",163,4067982,4068844,862,"50M","False","r"
"6602","ECK3876-JW5568","yihV",163,4067052,4068025,973,"50M","False","r"
"6604","ECK3875-JW3853","yihU",163,4066006,4066979,973,"50M","False","f"
"6606","ECK3874-JW3852","yihT",163,4065104,4066059,955,"50M","False","f"
"6608","ECK3873-JW5569","yihS",163,4063846,4065164,1318,"50M","False","f"
"6610","ECK3872-JW3850","yihR",163,4062806,4063809,1003,"50M","False","f"
"6612","ECK3871-JW3849","yihQ",163,4060571,4062684,2113,"50M","False","f"
"6614","ECK3870-JW3848","yihP",163,4059140,4060623,1483,"50M","False","f"
"6616","ECK3869-JW5852","yihO",163,4057694,4059180,1486,"50M","False","f"
"6618","ECK3868-JW3846","ompL",163,4056934,4057703,769,"50M","False","f"
"6620","ECK3867-JW3845","yihN",163,4055560,4056902,1342,"50M","False","r"
"6622","ECK3866-JW3844","yihM",163,4054478,4055535,1057,"50M","False","r"
"6624","ECK3865-JW3843","yihL",163,4053760,4054547,787,"50M","False","r"
"6626","ECK3864-JW5571","bipA",163,4051720,4053620,1900,"50M","False","r"
"6628","ECK3863-JW3841","glnA",163,4049956,4051442,1486,"50M","False","f"
"6630","ECK3862-JW3840","glnL",163,4048621,4049747,1126,"50M","False","f"
"6632","ECK3861-JW3839","glnG",163,4047200,4048686,1486,"50M","False","f"
"6634","none-JW5572","none",163,4046978,4047165,187,"50M","False","f"
"6636","ECK3860-JW3838","hemN",163,4045358,4046808,1450,"50M","False","r"
"6638","ECK3859-JW3837","yihI",163,4044660,4045246,586,"50M","False","r"
"6640","ECK3857-JW5930","yihA",163,4043464,4044173,709,"50M","False","f"
"6642","ECK3855-JW3835","polA",163,4040279,4043142,2863,"50M","False","r"
"6644","ECK3854-JW3834","yihG",163,4039001,4040010,1009,"50M","False","f"
"6646","ECK3853-JW5574","yihF",163,4037512,4039019,1507,"50M","False","r"
"6648","ECK3852-JW3832","dsbA",163,4036731,4037434,703,"50M","False","r"
"6650","ECK3851-JW3831","yihE",163,4035729,4036791,1062,"10M1I39M","False","r"
"6652","ECK3850-JW3830","yihD",163,4035382,4035728,346,"50M","False","r"
"6654","ECK3849-JW3829","mobA",163,4034746,4035407,661,"50M","False","f"
"6656","ECK3848-JW5575","mobB",163,4034237,4034826,589,"50M","False","f"
"6658","ECK3842-JW3827","hemG",163,4027921,4028543,622,"50M","False","r"
"6660","ECK3841-JW5576","trkH",163,4026458,4027986,1528,"50M","False","r"
"6662","ECK3840-JW5577","yigZ",163,4025802,4026496,694,"50M","False","r"
"6664","ECK3839-JW3823","pepQ",163,4024474,4025882,1408,"50M","False","r"
"6666","ECK3838-JW3822","fadB",163,4022113,4024379,2266,"50M","False","f"
"6668","ECK3837-JW5578","fadA",163,4020940,4022180,1240,"50M","False","f"
"6670","ECK3836-JW3820","fre",163,4019840,4020618,778,"50M","False","r"
"6672","ECK3835-JW3819","ubiD",163,4018301,4019871,1570,"50M","False","r"
"6674","ECK3834-JW3818","rfaH",163,4017664,4018229,565,"50M","False","f"
"6676","ECK3833-JW5931","tatD",163,4016855,4017726,871,"50M","False","r"
"6678","ECK3832-JW3815","tatC",163,4016049,4016902,853,"50M","False","r"
"6680","ECK3831-JW5580","tatB",163,4015531,4016123,592,"50M","False","r"
"6682","ECK3830-JW3813","tatA",163,4015258,4015604,346,"50M","False","r"
"6684","ECK3829-JW3812","ubiB",163,4013542,4015256,1714,"50M","False","r"
"6686","ECK3828-JW3811","yigP",163,4012937,4013619,682,"50M","False","r"
"6688","ECK3827-JW5581","ubiE",163,4012168,4013000,832,"50M","False","r"
"6690","ECK3826-JW3809","rmuC",163,4010646,4012150,1504,"50M","False","r"
"6692","ECK3825-JW3808","udp",163,4009744,4010582,838,"50M","False","r"
"6694","ECK3824-JW5853","ysgA",163,4008685,4009577,892,"50M","False","f"
"6696","ECK3823-JW3805","metE",163,4006366,4008704,2338,"50M","False","r"
"6698","ECK3822-JW3804","metR",163,4005194,4006224,1030,"50M","False","f"
"6700","ECK3821-JW3803","yigM",163,4004389,4005365,976,"50M","False","r"
"6702","ECK3820-JW5854","yigL",163,4003396,4004390,994,"50M","False","r"
"6704","ECK3819-JW5584","pldB",163,4002483,4003582,1099,"50M","False","r"
"6706","ECK3818-JW5585","rhtB",163,4001770,4002467,697,"50M","False","f"
"6708","ECK3817-JW5586","rhtC",163,4001070,4001767,697,"50M","False","r"
"6710","ECK3816-JW5855","recQ",163,3999171,4001083,1912,"50M","False","r"
"6712","ECK3815-JW3794","pldA",163,3998175,3999121,946,"50M","False","r"
"6714","ECK3814-JW5588","yigI",163,3997561,3998105,544,"50M","False","f"
"6716","ECK3813-JW5589","rarD",163,3996619,3997586,967,"50M","False","f"
"6718","ECK3812-JW5590","yigG",163,3996144,3996601,457,"50M","False","f"
"6720","ECK3811-JW3790","yigF",163,3995750,3996207,457,"50M","False","f"
"6722","ECK3810-JW3789","corA",163,3994739,3995766,1027,"50M","False","r"
"6724","ECK3809-JW5591","yigE",163,3993623,3994464,841,"50M","False","f"
"6726","ECK3808-JW3786","uvrD",163,3991296,3993535,2239,"50M","False","r"
"6728","ECK3807-JW3785","yigB",163,3990496,3991289,793,"50M","False","r"
"6730","ECK3806-JW3784","xerC",163,3989600,3990573,973,"50M","False","r"
"6732","ECK3805-JW3783","yigA",163,3988896,3989680,784,"50M","False","r"
"6734","ECK3804-JW5592","dapF",163,3988075,3988976,901,"50M","False","r"
"6736","ECK3803-JW3781","yifL",163,3987835,3988115,280,"50M","False","r"
"6738","ECK3802-JW3780","yzcX",163,3987163,3987725,562,"50M","False","r"
"6740","ECK3801-JW3779","cyaY",163,3987070,3987467,397,"50M","False","f"
"6742","ECK3800-JW3778","cyaA",163,3984466,3987089,2623,"50M","False","r"
"6744","ECK3799-JW5932","hemC",163,3983156,3984195,1039,"50M","False","f"
"6746","ECK3798-JW3776","hemD",163,3982419,3983233,814,"50M","False","f"
"6748","ECK3797-JW3775","hemX",163,3981216,3982474,1258,"50M","False","f"
"6750","ECK3796-JW3774","hemY",163,3980017,3981290,1273,"50M","False","f"
"6752","ECK3794-JW3773","aslA",163,3977683,3979415,1732,"50M","False","f"
"6754","ECK3793-JW5594","aslB",163,3976271,3977583,1312,"50M","False","r"
"6756","ECK3788-JW5595","yifK",163,3974200,3975662,1462,"50M","False","r"
"6758","ECK3787-JW3770","rffM",163,3973269,3974086,817,"50M","False","r"
"6760","ECK3786-JW3769","wzyE",163,3971914,3973343,1429,"50M","False","r"
"6762","ECK3785-JW5596","rffT",163,3970838,3971994,1156,"50M","False","r"
"6764","ECK3784-JW3766","wzxE",163,3969591,3970918,1327,"50M","False","r"
"6766","ECK3783-JW3765","rffA",163,3968459,3969666,1207,"50M","False","r"
"6768","ECK3782-JW5597","rffC",163,3967909,3968531,622,"50M","False","r"
"6770","ECK3781-JW3763","rffH",163,3966921,3967879,958,"50M","False","r"
"6772","ECK3780-JW5598","rffG",163,3965835,3966979,1144,"50M","False","r"
"6774","ECK3779-JW5599","rffD",163,3964573,3965912,1339,"50M","False","r"
"6776","ECK3778-JW5600","rffE",163,3963446,3964653,1207,"50M","False","r"
"6778","ECK3777-JW5601","wzzE",163,3962344,3963467,1123,"50M","False","r"
"6780","ECK3776-JW3758","rfe",163,3961229,3962409,1180,"50M","False","r"
"6782","ECK3775-JW3756","rho",163,3959730,3961066,1336,"50M","False","r"
"6784","ECK3774-JW3755","rhoL",163,3959544,3959722,178,"50M","False","r"
"6786","ECK3773-JW5856","trxA",163,3959020,3959480,460,"50M","False","r"
"6788","ECK3772-JW3753","rhlB",163,3957696,3959038,1342,"50M","False","f"
"6790","ECK3771-JW5603","gpp",163,3956076,3957637,1561,"50M","False","f"
"6792","ECK3770-JW5604","rep",163,3953990,3956088,2098,"50M","False","r"
"6794","ECK3769-JW3750","yifN",163,3953573,3953868,295,"50M","False","f"
"6796","ECK3768-JW3749","yifO",163,3953343,3953695,352,"50M","False","f"
"6798","ECK3767-JW3748","ppiC",163,3952862,3953221,359,"3M1D47M","False","f"
"6800","ECK3766-JW3747","ilvC",163,3951283,3952835,1552,"50M","False","r"
"6802","ECK3765-JW3746","ilvY",163,3950258,3951228,970,"50M","False","f"
"6804","ECK3764-JW3745","ilvA",163,3948644,3950265,1621,"50M","False","r"
"6806","ECK3763-JW5605","ilvD",163,3946791,3948718,1927,"50M","False","r"
"6808","ECK3762-JW5606","ilvE",163,3945797,3946803,1006,"50M","False","r"
"6810","ECK3761-JW3742","ilvM",163,3945514,3945854,340,"50M","False","r"
"6812","ECK3760-JW3741","ilvG",163,3944936,3945594,658,"50M","False","r"
"6814","ECK3760-JW3740","ilvG",163,3943873,3944933,1060,"50M","False","r"
"6816","ECK3759-JW3739","ilvL",163,3943635,3943810,175,"50M","False","r"
"6818","ECK3758-JW3738","yifB",163,3941780,3943407,1627,"50M","False","f"
"6820","ECK3757-JW3737","yifE",163,3941399,3941814,415,"50M","False","r"
"6822","ECK3756-JW5607","hdfR",163,3940896,3941375,479,"50M","False","f"
"6824","ECK3749-JW5608","yieP",163,3933966,3934735,769,"50M","False","f"
"6826","ECK3748-JW3733","hsrA",163,3932516,3934020,1504,"50M","False","f"
"6828","ECK3747-JW3732","rbsR",163,3931540,3932609,1069,"50M","False","r"
"6830","ECK3746-JW3731","rbsK",163,3930607,3931613,1006,"50M","False","r"
"6832","ECK3745-JW3730","rbsB",163,3929591,3930558,967,"50M","False","r"
"6834","ECK3744-JW3729","rbsC",163,3928601,3929643,1042,"50M","False","r"
"6836","ECK3743-JW3728","rbsA",163,3927091,3928673,1582,"50M","False","r"
"6838","ECK3742-JW5857","rbsD",163,3926628,3927160,532,"50M","False","r"
"6840","ECK3741-JW5609","trkD",163,3924629,3926574,1945,"50M","False","r"
"6842","ECK3740-JW3725","yieN",163,3922928,3924501,1573,"50M","False","f"
"6844","ECK3739-JW5610","yieM",163,3921483,3923011,1528,"50M","False","f"
"6846","ECK3738-JW3722","asnA",163,3920468,3921537,1069,"50M","False","r"
"6848","ECK3737-JW3721","asnC",163,3919876,3920411,535,"50M","False","f"
"6850","ECK3736-JW3720","mioC",163,3919343,3919863,520,"50M","False","f"
"6852","ECK3734-JW3719","gidA",163,3917075,3919041,1966,"50M","False","f"
"6854","ECK3733-JW3718","gidB",163,3916388,3917088,700,"50M","False","f"
"6856","ECK3732-JW5611","atpI",163,3915391,3915848,457,"50M","False","f"
"6858","ECK3731-JW3716","atpB",163,3914567,3915459,892,"50M","False","f"
"6860","ECK3730-JW3715","atpE",163,3914281,3914597,316,"50M","False","f"
"6862","ECK3729-JW3714","atpF",163,3913749,3914296,547,"50M","False","f"
"6864","ECK3728-JW3713","atpH",163,3913201,3913811,610,"50M","False","f"
"6866","ECK3727-JW3712","atpA",163,3911647,3913265,1618,"50M","False","f"
"6868","ECK3726-JW3711","atpG",163,3910733,3911673,940,"50M","False","f"
"6870","ECK3725-JW3710","atpD",163,3909324,3910783,1459,"50M","False","f"
"6872","ECK3724-JW3709","atpC",163,3908884,3909380,496,"50M","False","f"
"6874","ECK3723-JW3708","glmU",163,3907161,3908608,1447,"50M","False","f"
"6876","ECK3722-JW3707","glmS",163,3905170,3907076,1906,"50M","False","f"
"6878","ECK3721-JW3706","pstS",163,3903816,3904933,1117,"50M","False","f"
"6880","ECK3720-JW3705","pstC",163,3902770,3903806,1036,"50M","False","f"
"6882","ECK3719-JW3704","pstA",163,3901880,3902847,967,"50M","False","f"
"6884","ECK3718-JW3703","pstB",163,3900924,3901774,850,"50M","False","f"
"6886","ECK3717-JW3702","phoU",163,3900184,3900986,802,"50M","False","f"
"6888","ECK3716-JW3701","bglG",163,3899062,3899975,913,"50M","False","f"
"6890","ECK3715-JW3700","bglF",163,3897051,3899005,1954,"50M","False","f"
"6892","ECK3714-JW3699","bglB",163,3895620,3897109,1489,"50M","False","f"
"6894","ECK3713-JW3698","bglH",163,3893935,3895628,1693,"50M","False","f"
"6896","ECK3712-JW5612","yieL",163,3892739,3894012,1273,"50M","False","f"
"6898","ECK3711-JW5613","yieK",163,3892002,3892801,799,"50M","False","f"
"6900","ECK3710-JW3695","cbrC",163,3891335,3891999,664,"50M","False","r"
"6902","ECK3709-JW3694","yieI",163,3890819,3891363,544,"50M","False","r"
"6904","ECK3708-JW3693","yieH",163,3890087,3890829,742,"50M","False","r"
"6906","ECK3707-JW3692","yieG",163,3888603,3890017,1414,"50M","False","f"
"6908","ECK3706-JW3691","yieF",163,3887965,3888608,643,"50M","False","r"
"6910","ECK3705-JW3690","yieE",163,3887182,3888020,838,"50M","False","r"
"6912","ECK3704-JW3689","yidZ",163,3886078,3887114,1036,"50M","False","r"
"6914","ECK3703-JW3688","mdtL",163,3884928,3886180,1252,"50M","False","r"
"6920","ECK3701-JW3686","tnaA",163,3882043,3883535,1492,"50M","False","r"
"6922","ECK3700-JW3685","tnaC",163,3881748,3881899,151,"50M","False","r"
"6924","ECK3699-JW3684","trmE",163,3880141,3881582,1441,"50M","False","r"
"6926","ECK3698-JW3683","yidC",163,3878389,3880112,1723,"50M","False","r"
"6928","ECK3697-JW3682","yidD",163,3878165,3878463,298,"50M","False","r"
"6930","ECK3696-JW3681","rnpA",163,3877806,3878242,436,"50M","False","r"
"6932","ECK3695-JW3680","rpmH",163,3877649,3877866,217,"50M","False","r"
"6934","ECK3694-JW3679","dnaA",163,3875657,3877137,1480,"50M","False","f"
"6936","ECK3693-JW3678","dnaN",163,3874552,3875729,1177,"50M","False","f"
"6938","ECK3692-JW3677","recF",163,3873479,3874629,1150,"50M","False","f"
"6940","ECK3691-JW5625","gyrB",163,3871036,3873527,2491,"50M","False","f"
"6942","ECK3690-JW3675","yidB",163,3870398,3870873,475,"50M","False","f"
"6944","ECK3689-JW3674","yidA",163,3869471,3870360,889,"50M","False","f"
"6946","ECK3688-JW5858","yidX",163,3868757,3869484,727,"50M","False","r"
"6948","ECK3687-JW5627","dgoR",163,3867802,3868568,766,"50M","False","f"
"6950","ECK3686-JW3670","dgoK",163,3866927,3867882,955,"50M","False","f"
"6952","ECK3685-JW5628","dgoA",163,3866326,3867020,694,"50M","False","f"
"6954","ECK3684-JW5629","dgoD",163,3865181,3866406,1225,"50M","False","f"
"6956","ECK3683-JW5859","dgoT",163,3863769,3865165,1396,"50M","False","f"
"6958","ECK3682-JW5631","cbrA",163,3862690,3863831,1141,"50M","False","r"
"6960","ECK3681-JW5860","yidR",163,3861393,3862717,1324,"50M","False","f"
"6962","ECK3680-JW5633","yidQ",163,3861041,3861450,409,"50M","False","r"
"6964","ECK3679-JW3664","ibpA",163,3860340,3860830,490,"50M","False","f"
"6966","ECK3678-JW3663","ibpB",163,3859800,3860305,505,"50M","False","f"
"6968","ECK3677-JW3662","yidE",163,3857943,3859681,1738,"50M","False","f"
"6970","ECK3676-JW3661","yidP",163,3857212,3858005,793,"50M","False","r"
"6972","ECK3675-JW3660","glvC",163,3855828,3857011,1183,"50M","False","f"
"6974","ECK3674-JW3659","glvB",163,3855318,3855880,562,"50M","False","f"
"6976","ECK3673-JW3658","glvG",163,3854680,3855395,715,"50M","False","f"
"6978","ECK3672-JW5937","ysdC",163,3854504,3854793,289,"50M","False","f"
"6980","ECK3671-JW3656","yidL",163,3853566,3854566,1000,"50M","False","r"
"6982","ECK3670-JW3655","yidK",163,3851732,3853524,1792,"50M","False","f"
"6984","ECK3669-JW3654","yidJ",163,3850242,3851812,1570,"50M","False","f"
"6986","ECK3668-JW3653","yidI",163,3849728,3850254,526,"50M","False","r"
"6988","ECK3667-JW3652","yidH",163,3849291,3849715,424,"50M","False","f"
"6990","ECK3666-JW3651","yidG",163,3848939,3849378,439,"50M","False","f"
"6992","ECK3665-JW3650","yidF",163,3848445,3849019,574,"50M","False","f"
"6994","ECK3664-JW5634","emrD",163,3847235,3848496,1261,"50M","False","r"
"6996","none-JW5635","none",163,3846186,3846655,469,"50M","False","r"
"6998","ECK3663-JW3647","ivbL",163,3846221,3846396,175,"50M","False","f"
"7000","ECK3662-JW3646","ilvB",163,3844427,3846192,1765,"50M","False","f"
"7002","ECK3661-JW3645","ilvN",163,3844133,3844500,367,"50M","False","f"
"7004","ECK3660-JW3644","uhpA",163,3843467,3844134,667,"50M","False","f"
"7006","ECK3659-JW3643","uhpB",163,3841965,3843544,1579,"50M","False","f"
"7008","ECK3658-JW3642","uhpC",163,3840636,3842032,1396,"50M","False","f"
"7010","ECK3657-JW3641","uhpT",163,3839107,3840575,1468,"50M","False","f"
"7012","ECK3656-JW3640","ade",163,3837277,3839120,1843,"50M","False","r"
"7014","ECK3655-JW5636","yicO",163,3835786,3837197,1411,"50M","False","f"
"7016","ECK3654-JW5637","yicN",163,3835281,3835810,529,"50M","False","f"
"7018","ECK3653-JW5938","yicM",163,3833880,3835147,1267,"50M","False","f"
"7020","ECK3652-JW5965","yicS",163,3833528,3833898,370,"50M","False","r"
"7022","none-JW5639","none",163,3833404,3833600,196,"50M","False","r"
"7024","ECK3651-JW3635","nlpA",163,3832506,3833401,895,"50M","False","f"
"7026","ECK3650-JW3634","yicL",163,3831561,3832561,1000,"50M","False","r"
"7028","ECK3649-JW3633","setC",163,3830266,3831527,1261,"50M","False","r"
"7030","ECK3647-JW5939","yicJ",163,3827878,3829382,1504,"50M","False","f"
"7032","ECK3646-JW3631","yicI",163,3825550,3827945,2395,"50M","False","f"
"7034","ECK3645-JW3630","yicH",163,3823770,3825556,1786,"50M","False","r"
"7036","ECK3644-JW3629","yicE",163,3822258,3823726,1468,"50M","False","r"
"7038","ECK3643-JW3628","gltS",163,3820791,3822073,1282,"50M","False","f"
"7040","ECK3642-JW3627","recG",163,3818523,3820681,2158,"50M","False","r"
"7042","ECK3641-JW3626","trmH",163,3817828,3818594,766,"50M","False","r"
"7044","ECK3640-JW3625","spoT",163,3815713,3817898,2185,"50M","False","r"
"7046","ECK3639-JW3624","rpoZ",163,3815419,3815771,352,"50M","False","r"
"7048","ECK3638-JW3623","gmk",163,3814741,3815441,700,"50M","False","r"
"7050","ECK3637-JW3622","ligB",163,3812819,3814578,1759,"50M","False","f"
"7052","ECK3636-JW3621","yicG",163,3812187,3812881,694,"50M","False","r"
"7054","ECK3635-JW3620","dinD",163,3811073,3811974,901,"50M","False","r"
"7056","ECK3634-JW3619","yicC",163,3809989,3810929,940,"50M","False","r"
"7058","ECK3633-JW3618","rph",163,3809194,3809957,763,"50M","False","f"
"7060","ECK3632-JW3617","pyrE",163,3808458,3809176,718,"50M","False","f"
"7062","ECK3631-JW5641","ttk",163,3807807,3808480,673,"50M","False","r"
"7064","ECK3630-JW3615","dut",163,3807245,3807777,532,"50M","False","r"
"7066","ECK3629-JW5642","dfp",163,3806044,3807341,1297,"50M","False","r"
"7068","ECK3628-JW5643","yicR",163,3805222,3805967,745,"50M","False","f"
"7070","ECK3627-JW3612","rpmB",163,3804769,3805082,313,"50M","False","f"
"7072","ECK3626-JW3611","rpmG",163,3804581,3804825,244,"50M","False","f"
"7074","ECK3625-JW3610","mutM",163,3803674,3804560,886,"50M","False","f"
"7076","ECK3624-JW3609","coaD",163,3803138,3803694,556,"50M","False","r"
"7078","ECK3623-JW3608","kdtA",163,3801853,3803207,1354,"50M","False","r"
"7080","ECK3622-JW3607","rfaQ",163,3800395,3801506,1111,"50M","False","f"
"7082","ECK3621-JW3606","rfaG",163,3799274,3800475,1201,"50M","False","f"
"7084","ECK3620-JW3605","rfaP",163,3798484,3799358,874,"50M","False","f"
"7086","ECK3619-JW3604","rfaS",163,3797512,3798524,1012,"50M","False","f"
"7088","ECK3618-JW3603","rfaB",163,3796389,3797575,1186,"50M","False","f"
"7090","ECK3617-JW3602","rfaI",163,3795370,3796466,1096,"50M","False","f"
"7092","ECK3616-JW3601","rfaJ",163,3794314,3795407,1093,"50M","False","f"
"7094","ECK3615-JW3600","rfaY",163,3793598,3794373,775,"50M","False","f"
"7096","ECK3614-JW3599","rfaZ",163,3792676,3793604,928,"50M","False","f"
"7098","ECK3613-JW3598","rfaK",163,3791570,3792720,1150,"50M","False","f"
"7100","ECK3612-JW3597","rfaL",163,3790261,3791597,1336,"50M","False","r"
"7102","ECK3611-JW3596","rfaC",163,3789292,3790328,1036,"50M","False","r"
"7104","ECK3610-JW3595","rfaF",163,3788242,3789365,1123,"50M","False","r"
"7106","ECK3609-JW3594","rfaD",163,3787300,3788309,1009,"50M","False","r"
"7108","ECK3608-JW5644","htrL",163,3786157,3787091,934,"50M","False","f"
"7110","ECK3607-JW3592","kbl",163,3784686,3785959,1273,"50M","False","f"
"7112","ECK3606-JW3591","tdh",163,3783651,3784753,1102,"50M","False","f"
"7114","ECK3605-JW3590","yibD",163,3782378,3783489,1111,"50M","False","f"
"7116","ECK3604-JW5645","yibQ",163,3781414,3782450,1036,"50M","False","r"
"7118","ECK3603-JW5646","envC",163,3780127,3781487,1360,"50M","False","r"
"7120","ECK3602-JW3587","gpmI",163,3778573,3780194,1621,"50M","False","r"
"7122","ECK3601-JW3586","yibN",163,3777915,3778423,508,"50M","False","f"
"7124","ECK3600-JW3585","grxC",163,3777522,3777850,328,"50M","False","f"
"7126","ECK3599-JW3584","secB",163,3776992,3777536,544,"50M","False","f"
"7128","ECK3598-JW3583","gpsA",163,3775973,3777069,1096,"50M","False","f"
"7130","ECK3597-JW3582","cysE",163,3775072,3775970,898,"50M","False","f"
"7132","ECK3596-JW3581","yibK",163,3774528,3775078,550,"50M","False","r"
"7134","ECK3595-JW3580","lldD",163,3773140,3774407,1267,"50M","False","r"
"7136","ECK3594-JW3579","lldR",163,3772367,3773220,853,"50M","False","r"
"7138","ECK3593-JW3578","lldP",163,3770712,3772444,1732,"50M","False","r"
"7140","ECK3592-JW3577","yibL",163,3769978,3770417,439,"50M","False","r"
"7142","ECK3591-JW3576","yibT",163,3769502,3769788,286,"50M","False","f"
"7144","ECK3590-JW3575","mtlR",163,3768885,3769549,664,"50M","False","r"
"7146","ECK3589-JW3574","mtlD",163,3767737,3768962,1225,"50M","False","r"
"7148","ECK3588-JW3573","mtlA",163,3765594,3767584,1990,"50M","False","r"
"7150","ECK3587-JW3572","yibI",163,3764713,3765152,439,"50M","False","f"
"7152","ECK3586-JW3571","yibH",163,3763574,3764787,1213,"50M","False","f"
"7154","ECK3585-JW3570","yibG",163,3761490,3762028,538,"50M","False","r"
"7156","ECK3584-JW5647","yibJ",163,3760534,3761312,778,"50M","False","r"
"7158","ECK3583-JW3568","yibA",163,3759650,3760569,919,"50M","False","r"
"7160","ECK3582-JW3566","rhsA",161,3755496,3759706,4210,"50M","False","r"
"7162","ECK3581-JW3565","yibF",163,3754678,3755363,685,"50M","False","f"
"7164","ECK3580-JW3564","selA",163,3753189,3754657,1468,"50M","False","f"
"7166","ECK3579-JW3563","selB",163,3751348,3753269,1921,"50M","False","f"
"7168","ECK3578-JW5648","yiaY",163,3750007,3751235,1228,"50M","False","f"
"7170","ECK3577-JW3561","aldB",163,3748304,3749919,1615,"50M","False","f"
"7172","ECK3576-JW3559","yiaW",163,3747436,3747836,400,"50M","False","f"
"7174","ECK3575-JW3558","yiaV",163,3746294,3747507,1213,"50M","False","f"
"7176","ECK3574-JW3557","yiaU",163,3745305,3746356,1051,"50M","False","r"
"7178","ECK3573-JW3556","yiaT",163,3744459,3745276,817,"50M","False","f"
"7180","none-JW5649","none",163,3744186,3744736,550,"50M","False","r"
"7182","ECK3572-JW3555","sgbE",163,3743399,3744171,772,"50M","False","r"
"7184","ECK3571-JW5650","sgbU",163,3742545,3743482,937,"50M","False","r"
"7186","ECK3570-JW3553","sgbH",163,3741890,3742629,739,"50M","False","r"
"7188","ECK3569-JW3552","lyxK",163,3740397,3741970,1573,"50M","False","r"
"7190","ECK3568-JW3551","yiaO",163,3739407,3740470,1063,"50M","False","r"
"7192","ECK3567-JW5651","yiaN",163,3738117,3739471,1354,"50M","False","r"
"7194","ECK3566-JW3549","yiaM",163,3737641,3738191,550,"50M","False","r"
"7196","ECK3565-JW3548","yiaL",163,3737056,3737600,544,"50M","False","r"
"7198","ECK3564-JW3547","yiaK",163,3736046,3737121,1075,"50M","False","r"
"7200","ECK3563-JW3546","yiaJ",163,3735015,3735940,925,"50M","False","f"
"7202","ECK3562-JW3545","yiaI",163,3734440,3734990,550,"50M","False","f"
"7204","ECK3561-JW5652","avtA",163,3733018,3734348,1330,"50M","False","r"
"7206","ECK3560-JW3543","malS",163,3730810,3732917,2107,"50M","False","r"
"7208","ECK3559-JW5653","bax",163,3729684,3730585,901,"50M","False","f"
"7210","ECK3558-JW3541","xylR",163,3728292,3729547,1255,"50M","False","r"
"7212","ECK3557-JW3540","xylH",163,3727033,3728291,1258,"50M","False","r"
"7214","ECK3556-JW3539","xylG",163,3725514,3727132,1618,"50M","False","r"
"7216","ECK3555-JW3538","xylF",163,3724444,3725513,1069,"50M","False","r"
"7218","ECK3554-JW3537","xylA",163,3722774,3724173,1399,"50M","False","f"
"7220","ECK3553-JW3536","xylB",163,3721248,3722779,1531,"50M","False","f"
"7222","ECK3552-JW5654","yiaB",163,3720738,3721156,418,"50M","False","f"
"7224","ECK3551-JW3534","yiaA",163,3720255,3720769,514,"50M","False","f"
"7226","ECK3550-JW3533","yiaH",163,3719200,3720272,1072,"50M","False","r"
"7228","ECK3549-JW3532","ysaB",163,3718744,3719120,376,"50M","False","f"
"7230","ECK3548-JW3531","glyQ",163,3717738,3718726,988,"50M","False","f"
"7232","ECK3547-JW3530","glyS",163,3715659,3717805,2146,"50M","False","f"
"7234","ECK3544-JW3526","hokA",163,3713779,3714008,229,"50M","False","f"
"7236","ECK3543-JW3525","cspA",163,3713362,3713651,289,"50M","False","r"
"7238","ECK3542-JW3524","yiaG",163,3712791,3713158,367,"50M","False","r"
"7240","ECK3541-JW5655","yiaF",163,3711665,3712452,787,"50M","False","f"
"7242","ECK3540-JW5656","tiaE",163,3710623,3711674,1051,"50M","False","r"
"7244","ECK3539-JW5657","yiaD",163,3709860,3710596,736,"50M","False","r"
"7246","ECK3538-JW5940","bisC",163,3707392,3709802,2410,"50M","False","f"
"7248","ECK3537-JW3519","yiaC",163,3706965,3707482,517,"50M","False","r"
"7250","ECK3536-JW3518","tag",163,3706405,3707045,640,"50M","False","r"
"7252","ECK3535-JW5659","yhjY",163,3705567,3706342,775,"50M","False","f"
"7254","ECK3534-JW3516","yhjX",163,3704130,3705415,1285,"50M","False","f"
"7256","ECK3533-JW5660","eptB",163,3702115,3703883,1768,"50M","False","f"
"7258","none-JW5661","none",163,3701551,3701969,418,"50M","False","f"
"7260","ECK3531-JW3513","dppA",163,3699429,3701113,1684,"50M","False","f"
"7262","none-JW5662","none",163,3699190,3699425,235,"50M","False","r"
"7264","ECK3530-JW3512","dppB",163,3698102,3699198,1096,"50M","False","f"
"7266","ECK3529-JW3511","dppC",163,3697190,3698169,979,"50M","False","f"
"7268","ECK3528-JW3510","dppD",163,3696196,3697256,1060,"50M","False","f"
"7270","ECK3527-JW3509","dppF",163,3695195,3696276,1081,"50M","False","f"
"7272","ECK3526-JW3508","yhjV",163,3693876,3695224,1348,"50M","False","r"
"7274","ECK3523-JW3506","bcsG",163,3691527,3693283,1756,"50M","False","r"
"7276","ECK3522-JW5663","bcsF",163,3691339,3691607,268,"50M","False","r"
"7278","ECK3521-JW3504","bcsE",163,3689771,3691419,1648,"50M","False","r"
"7280","ECK3520-JW3503","yhjR",163,3689328,3689593,265,"50M","False","f"
"7282","ECK3519-JW5941","yhjQ",163,3688564,3689357,793,"50M","False","f"
"7284","ECK3518-JW5665","bcsA",163,3685949,3688644,2695,"50M","False","f"
"7286","ECK3517-JW3500","bcsB",163,3683599,3686015,2416,"50M","False","f"
"7288","ECK3516-JW3499","bcsZ",163,3682486,3683669,1183,"50M","False","f"
"7290","ECK3515-JW5942","bcsC",161,3679031,3682581,3550,"50M","False","f"
"7292","ECK3514-JW5943","yhjK",163,3676961,3678987,2026,"50M","False","f"
"7294","ECK3513-JW3496","dctA",163,3675492,3676855,1363,"50M","False","f"
"7296","ECK3512-JW3495","yhjJ",163,3673775,3675348,1573,"50M","False","f"
"7298","ECK3511-JW5668","kdgK",163,3672732,3673738,1006,"50M","False","r"
"7300","ECK3510-JW3493","yhjH",163,3671751,3672595,844,"50M","False","f"
"7302","ECK3509-JW3492","yhjG",163,3669621,3671773,2152,"50M","False","f"
"7304","ECK3508-JW3491","yhjE",163,3668099,3669498,1399,"50M","False","r"
"7306","ECK3507-JW3490","yhjD",163,3666675,3667765,1090,"50M","False","r"
"7308","ECK3506-JW3489","yhjC",163,3665655,3666703,1048,"50M","False","r"
"7310","ECK3505-JW3488","yhjB",163,3664623,3665302,679,"50M","False","f"
"7312","ECK3504-JW3487","treF",163,3662905,3664631,1726,"50M","False","r"
"7314","ECK3503-JW3486","yhjA",163,3661122,3662596,1474,"50M","False","f"
"7316","ECK3502-JW3485","gadA",163,3659511,3660988,1477,"50M","False","f"
"7318","ECK3501-JW3484","gadX",163,3658317,3659218,901,"50M","False","f"
"7320","ECK3499-JW3483","gadW",163,3657221,3658026,805,"50M","False","f"
"7322","ECK3498-JW3482","mdtF",163,3653727,3656917,3190,"50M","False","r"
"7324","ECK3497-JW3481","mdtE",163,3652545,3653779,1234,"50M","False","r"
"7326","ECK3496-JW3480","gadE",163,3651679,3652283,604,"50M","False","r"
"7328","ECK3495-JW3479","hdeD",163,3650308,3650957,649,"50M","False","r"
"7330","ECK3494-JW3478","hdeA",163,3649739,3650148,409,"50M","False","f"
"7332","ECK3493-JW5669","hdeB",163,3649297,3649700,403,"50M","False","f"
"7334","ECK3492-JW5670","yhiD",163,3648586,3649310,724,"50M","False","f"
"7336","ECK3491-JW3475","yhiF",163,3647996,3648603,607,"50M","False","r"
"7338","ECK3490-JW3474","slp",163,3647274,3647917,643,"50M","False","r"
"7340","ECK3489-JW3471","yhiS",163,3644604,3645463,859,"50M","False","r"
"7342","ECK3488-JW3470","arsC",163,3643550,3644052,502,"50M","False","r"
"7344","ECK3487-JW3469","arsB",163,3642248,3643614,1366,"50M","False","r"
"7346","ECK3486-JW3468","arsR",163,3641841,3642271,430,"50M","False","r"
"7348","ECK3485-JW3467","gor",163,3639612,3641041,1429,"50M","False","r"
"7350","ECK3484-JW3466","yhiR",163,3638698,3639617,919,"50M","False","r"
"7352","ECK3483-JW3465","prlC",163,3636471,3638590,2119,"50M","False","f"
"7354","ECK3482-JW5672","yhiQ",163,3635711,3636540,829,"50M","False","f"
"7356","ECK3481-JW3463","yhiP",163,3634175,3635721,1546,"50M","False","r"
"7358","ECK3480-JW3462","uspA",163,3633424,3633935,511,"50M","False","r"
"7360","ECK3479-JW3461","yhiO",163,3632716,3633128,412,"50M","False","f"
"7362","ECK3478-JW3460","pitA",163,3630955,3632531,1576,"50M","False","r"
"7364","ECK3477-JW3459","yhiN",163,3629539,3630818,1279,"50M","False","f"
"7366","ECK3476-JW5944","yhiM",163,3628112,3629283,1171,"50M","False","r"
"7368","ECK3475-JW3457","yhiL",163,3626551,3627866,1315,"50M","False","f"
"7370","ECK3474-JW5674","yhiK",163,3626183,3626652,469,"50M","False","f"
"7372","ECK3473-JW3455","yhiJ",163,3624299,3625998,1699,"50M","False","f"
"7374","none-JW5675","none",163,3623926,3624134,208,"50M","False","f"
"7376","ECK3472-JW3454","yhiI",163,3622865,3624010,1145,"5M1D45M","False","f"
"7378","ECK3471-JW5676","rbbA",163,3620134,3622946,2812,"50M","False","f"
"7380","ECK3470-JW5677","yhhJ",163,3619010,3620211,1201,"50M","False","f"
"7382","ECK3469-JW3451","yhhI",163,3617691,3618904,1213,"50M","False","r"
"7384","ECK3468-JW5678","yrhC",163,3617200,3617522,322,"50M","False","r"
"7386","ECK3467-JW3449","yhhH",163,3616712,3617172,460,"50M","False","r"
"7388","ECK3466-JW5679","rhsB",161,3612505,3616817,4312,"50M","False","r"
"7390","ECK3465-JW3446","nikR",163,3611901,3612379,478,"50M","False","r"
"7392","ECK3464-JW3445","nikE",163,3611089,3611972,883,"50M","False","r"
"7394","ECK3463-JW3444","nikD",163,3610328,3611169,841,"50M","False","r"
"7396","ECK3462-JW3443","nikC",163,3609495,3610405,910,"50M","False","r"
"7398","ECK3461-JW3442","nikB",163,3608554,3609575,1021,"50M","False","r"
"7400","ECK3460-JW3441","nikA",163,3606980,3608631,1651,"50M","False","r"
"7402","ECK3459-JW3440","acpT",163,3606282,3606946,664,"50M","False","r"
"7404","ECK3458-JW5680","yhhT",163,3605178,3606304,1126,"50M","False","r"
"7406","ECK3457-JW5945","yhhS",163,3603847,3605174,1327,"50M","False","f"
"7408","ECK3456-JW5682","dcrB",163,3603268,3603902,634,"50M","False","r"
"7410","ECK3455-JW3436","yhhQ",163,3602530,3603272,742,"50M","False","r"
"7412","ECK3454-JW3435","yhhP",163,3602082,3602404,322,"50M","False","f"
"7414","ECK3453-JW3434","zntA",163,3599764,3602039,2275,"50M","False","r"
"7416","ECK3452-JW3433","yhhN",163,3599064,3599767,703,"50M","False","r"
"7418","ECK3451-JW3432","yhhM",163,3598582,3599018,436,"50M","False","f"
"7420","ECK3450-JW5683","yhhL",163,3598292,3598638,346,"50M","False","r"
"7422","ECK3449-JW3430","yhhF",163,3597706,3598379,673,"50M","False","r"
"7424","ECK3448-JW3429","ftsY",163,3596081,3597651,1570,"50M","False","f"
"7426","ECK3447-JW3428","ftsE",163,3595410,3596155,745,"50M","False","f"
"7428","ECK3446-JW3427","ftsX",163,3594359,3595494,1135,"50M","False","f"
"7430","ECK3445-JW3426","rpoH",163,3593260,3594191,931,"50M","False","f"
"7432","ECK3444-JW3425","livJ",163,3591886,3593066,1180,"50M","False","f"
"7434","ECK3443-JW3424","yhhK",163,3591297,3591757,460,"50M","False","r"
"7436","ECK3442-JW3423","livK",163,3589782,3590968,1186,"50M","False","f"
"7438","ECK3441-JW3422","livH",163,3588808,3589811,1003,"50M","False","f"
"7440","ECK3440-JW3421","livM",163,3587534,3588888,1354,"50M","False","f"
"7442","ECK3439-JW3420","livG",163,3586770,3587614,844,"50M","False","f"
"7444","ECK3438-JW3419","livF",163,3586055,3586845,790,"50M","False","f"
"7446","ECK3437-JW3418","ugpB",163,3584340,3585733,1393,"50M","False","f"
"7448","ECK3436-JW3417","ugpA",163,3583355,3584319,964,"50M","False","f"
"7450","ECK3435-JW3416","ugpE",163,3582513,3583435,922,"50M","False","f"
"7452","ECK3434-JW3415","ugpC",163,3581441,3582588,1147,"50M","False","f"
"7454","ECK3433-JW3414","ugpQ",163,3580701,3581521,820,"50M","False","f"
"7456","ECK3432-JW3413","yhhA",163,3580256,3580773,517,"50M","False","r"
"7458","ECK3431-JW3412","ggt",163,3578412,3580231,1819,"50M","False","f"
"7460","ECK3430-JW3411","yrhB",163,3578072,3578433,361,"50M","False","r"
"7462","none-JW5684","none",163,3577717,3577949,232,"50M","False","r"
"7464","ECK3429-JW5864","yrhA",163,3576351,3576844,493,"50M","False","r"
"7466","ECK3428-JW3406","yhhZ",163,3575176,3576431,1255,"50M","False","r"
"7468","ECK3427-JW3405","yhhY",163,3574451,3575016,565,"50M","False","r"
"7470","ECK3425-JW3403","yhhX",163,3573099,3574213,1114,"50M","False","f"
"7472","ECK3424-JW3402","yhhW",163,3572281,3573053,772,"50M","False","f"
"7474","ECK3423-JW5946","gntR",163,3571062,3572077,1015,"50M","False","f"
"7476","ECK3422-JW3400","gntK",163,3570396,3571000,604,"50M","False","f"
"7478","ECK3421-JW5686","gntU",163,3569052,3570469,1417,"50M","False","f"
"7480","ECK3420-JW3397","yhgN",163,3568384,3569054,670,"50M","False","r"
"7482","ECK3419-JW3396","asd",163,3567106,3568286,1180,"50M","False","f"
"7484","ECK3418-JW3395","glgB",163,3564647,3566910,2263,"50M","False","f"
"7486","ECK3417-JW3394","glgX",163,3562677,3564727,2050,"50M","False","f"
"7488","ECK3416-JW3393","glgC",163,3561364,3562736,1372,"50M","False","f"
"7490","ECK3415-JW3392","glgA",163,3559931,3561441,1510,"50M","False","f"
"7492","ECK3414-JW3391","glgP",163,3557465,3559989,2524,"50M","False","f"
"7494","ECK3413-JW3390","yzgL",163,3557055,3557413,358,"50M","False","f"
"7496","ECK3412-JW3389","glpD",163,3555326,3556908,1582,"50M","False","r"
"7498","ECK3411-JW3388","glpE",163,3554828,3555231,403,"50M","False","f"
"7500","ECK3410-JW5687","glpG",163,3553953,3554860,907,"50M","False","f"
"7502","ECK3409-JW3386","glpR",163,3553178,3554013,835,"50M","False","f"
"7504","ECK3408-JW3385","rtcR",163,3551580,3553255,1675,"50M","False","r"
"7506","ECK3407-JW3384","rtcB",163,3550183,3551486,1303,"50M","False","f"
"7508","ECK3406-JW5688","rtcA",163,3549163,3550256,1093,"50M","False","f"
"7510","ECK3405-JW3381","malT",163,3546397,3549179,2782,"50M","False","r"
"7512","ECK3404-JW5689","malP",163,3543410,3545880,2470,"50M","False","f"
"7514","ECK3403-JW3379","malQ",163,3541316,3543477,2161,"50M","False","f"
"7516","ECK3402-JW5690","gntT",163,3539871,3541264,1393,"50M","False","r"
"7518","ECK3401-JW3377","gntY",163,3538936,3539588,652,"50M","False","r"
"7520","ECK3400-JW5691","gntX",163,3538194,3538954,760,"50M","False","r"
"7522","ECK3399-JW3375","bioH",163,3537404,3538251,847,"50M","False","f"
"7524","ECK3398-JW3374","yhgA",163,3536479,3537434,955,"50M","False","r"
"7526","ECK3397-JW3373","yhgG",163,3536040,3536353,313,"50M","False","r"
"7528","ECK3396-JW3372","feoB",163,3533719,3536117,2398,"50M","False","r"
"7530","ECK3395-JW3371","feoA",163,3533475,3533779,304,"50M","False","r"
"7532","ECK3394-JW3370","yhgF",163,3530697,3533095,2398,"50M","False","r"
"7534","ECK3393-JW3369","greB",163,3530124,3530677,553,"50M","False","r"
"7536","ECK3392-JW3368","ompR",163,3529195,3529991,796,"50M","False","f"
"7538","ECK3391-JW3367","envZ",163,3527846,3529275,1429,"50M","False","f"
"7540","ECK3390-JW3366","pck",163,3526130,3527829,1699,"50M","False","r"
"7542","ECK3389-JW3365","yhgE",163,3524045,3525846,1801,"50M","False","f"
"7544","ECK3388-JW5692","hslO",163,3523086,3524041,955,"50M","False","r"
"7546","ECK3387-JW3363","hslR",163,3522660,3523138,478,"50M","False","r"
"7548","ECK3386-JW5865","yrfG",163,3521936,3522726,790,"50M","False","r"
"7550","ECK3385-JW3361","yrfF",163,3519781,3521993,2212,"50M","False","r"
"7552","ECK3384-JW3360","nudE",163,3518919,3519556,637,"50M","False","f"
"7554","ECK3383-JW3359","mrcA",163,3516183,3518812,2629,"50M","False","r"
"7556","ECK3382-JW5693","yrfD",163,3515302,3516158,856,"50M","False","f"
"7558","ECK3381-JW3357","yrfC",163,3514763,3515379,616,"50M","False","f"
"7560","ECK3380-JW3356","yrfB",163,3514339,3514856,517,"50M","False","f"
"7562","ECK3379-JW5694","yrfA",163,3513945,3514426,481,"50M","False","f"
"7564","ECK3378-JW3354","hofQ",163,3512795,3514110,1315,"50M","False","f"
"7566","ECK3377-JW5947","aroK",163,3511873,3512672,799,"50M","False","f"
"7568","ECK3376-JW3352","aroB",163,3510728,3511893,1165,"50M","False","f"
"7570","ECK3375-JW3351","damX",163,3509350,3510713,1363,"50M","False","f"
"7572","ECK3374-JW3350","dam",163,3508407,3509320,913,"50M","False","f"
"7574","ECK3373-JW3349","rpe",163,3507712,3508466,754,"50M","False","f"
"7576","ECK3372-JW3348","gph",163,3506961,3507796,835,"50M","False","f"
"7578","ECK3371-JW3347","trpS",163,3505964,3507045,1081,"50M","False","f"
"7580","ECK3370-JW5948","yhfZ",163,3504769,3505532,763,"50M","False","f"
"7582","ECK3369-JW5696","yhfY",163,3504390,3504829,439,"50M","False","f"
"7584","ECK3368-JW3344","yhfX",163,3503143,3504383,1240,"50M","False","f"
"7586","ECK3367-JW3343","yhfW",163,3501917,3503220,1303,"50M","False","f"
"7588","ECK3366-JW3342","php",163,3501042,3501997,955,"50M","False","f"
"7590","ECK3365-JW5697","yhfU",163,3500678,3501108,430,"50M","False","f"
"7592","ECK3364-JW3340","yhfT",163,3499362,3500743,1381,"50M","False","f"
"7594","ECK3363-JW3339","yhfS",163,3498265,3499427,1162,"50M","False","f"
"7596","ECK3362-JW5698","frlR",163,3497364,3498172,808,"50M","False","r"
"7598","ECK3361-JW3337","frlD",163,3496479,3497341,862,"50M","False","r"
"7600","ECK3360-JW5699","frlC",163,3495652,3496559,907,"50M","False","r"
"7602","ECK3359-JW5700","frlB",163,3494580,3495679,1099,"50M","False","r"
"7604","ECK3358-JW3333","frlA",163,3493222,3494636,1414,"50M","False","r"
"7606","ECK3357-JW3332","yhfL",163,3492760,3493004,244,"50M","False","r"
"7608","ECK3356-JW3331","cysG",163,3491140,3492590,1450,"50M","False","r"
"7610","ECK3355-JW3330","nirC",163,3490315,3491198,883,"50M","False","r"
"7612","ECK3354-JW3329","nirD",163,3489863,3490266,403,"50M","False","r"
"7614","ECK3353-JW3328","nirB",163,3487323,3489943,2620,"50M","False","r"
"7616","ECK3352-JW3327","tsgA",163,3485880,3487138,1258,"50M","False","r"
"7618","ECK3351-JW3326","ppiA",163,3485055,3485704,649,"50M","False","f"
"7620","ECK3350-JW3325","yhfG",163,3484783,3485027,244,"50M","False","f"
"7622","ECK3349-JW3324","fic",163,3484191,3484870,679,"50M","False","f"
"7624","ECK3348-JW3323","pabA",163,3483596,3484236,640,"50M","False","f"
"7626","ECK3347-JW3322","argD",163,3482290,3483587,1297,"50M","False","f"
"7628","ECK3346-JW5701","yhfK",163,3480103,3482282,2179,"50M","False","r"
"7630","ECK3345-JW5702","crp",163,3479432,3480141,709,"50M","False","r"
"7632","ECK3344-JW3319","yhfA",163,3478744,3479225,481,"50M","False","f"
"7634","ECK3343-JW3318","prkB",163,3477802,3478748,946,"50M","False","r"
"7636","ECK3342-JW3317","yheU",163,3477530,3477825,295,"50M","False","r"
"7638","ECK3341-JW3316","yheT",163,3476514,3477613,1099,"50M","False","r"
"7640","ECK3340-JW3315","yheS",163,3474601,3476591,1990,"50M","False","r"
"7642","ECK3339-JW3314","kefG",163,3473937,3474568,631,"50M","False","f"
"7644","ECK3338-JW3313","kefB",163,3472132,3474014,1882,"50M","False","f"
"7646","ECK3337-JW3312","yheV",163,3471922,3472199,277,"50M","False","f"
"7648","ECK3336-JW3311","slyD",163,3471237,3471904,667,"50M","False","f"
"7650","ECK3335-JW3310","slyX",163,3470952,3471247,295,"50M","False","r"
"7652","ECK3334-JW3309","fkpA",163,3469937,3470826,889,"50M","False","f"
"7654","ECK3333-JW5703","yheO",163,3469048,3469847,799,"50M","False","f"
"7656","ECK3332-JW3307","yheN",163,3468662,3469125,463,"50M","False","f"
"7658","ECK3331-JW3306","yheM",163,3468303,3468739,436,"50M","False","f"
"7660","ECK3330-JW3305","yheL",163,3468008,3468372,364,"50M","False","f"
"7662","ECK3329-JW3304","rpsL",163,3467508,3467959,451,"50M","False","f"
"7664","ECK3328-JW3303","rpsG",163,3466872,3467488,616,"50M","False","f"
"7666","ECK3327-JW3302","fusA",163,3464730,3466921,2191,"50M","False","f"
"7668","ECK3326-JW3301","tufA",163,3463475,3464736,1261,"50M","False","f"
"7670","ECK3325-JW3300","chiA",163,3460490,3463260,2770,"50M","False","f"
"7672","ECK3324-JW3299","bfd",163,3460127,3460398,271,"50M","False","f"
"7674","ECK3323-JW3298","bfr",163,3459579,3460132,553,"50M","False","f"
"7676","ECK3322-JW3297","gspO",163,3458855,3459609,754,"50M","False","r"
"7678","ECK3321-JW5704","gspM",163,3458394,3458932,538,"50M","False","r"
"7680","ECK3320-JW5705","gspL",163,3457234,3458474,1240,"50M","False","r"
"7682","ECK3319-JW3294","gspK",163,3456236,3457296,1060,"50M","False","r"
"7684","ECK3318-JW3293","gspJ",163,3455656,3456320,664,"50M","False","r"
"7686","ECK3317-JW5706","gspI",163,3455286,3455740,454,"50M","False","r"
"7688","ECK3316-JW3291","gspH",163,3454780,3455366,586,"50M","False","r"
"7690","ECK3315-JW3290","gspG",163,3454335,3454849,514,"50M","False","r"
"7692","ECK3314-JW3289","gspF",163,3453129,3454402,1273,"50M","False","r"
"7694","ECK3313-JW3288","gspE",163,3451651,3453209,1558,"50M","False","r"
"7696","ECK3312-JW5707","gspD",163,3449677,3451718,2041,"50M","False","r"
"7698","ECK3311-JW3286","gspC",163,3448890,3449782,892,"50M","False","r"
"7700","ECK3310-JW3285","gspA",163,3447259,3448805,1546,"50M","False","f"
"7702","ECK3309-JW3284","pioO",163,3446838,3447334,496,"50M","False","f"
"7704","ECK3308-JW3283","rpsJ",163,3446289,3446677,388,"50M","False","f"
"7706","ECK3307-JW3282","rplC",163,3445627,3446333,706,"50M","False","f"
"7708","ECK3306-JW3281","rplD",163,3445011,3445693,682,"50M","False","f"
"7710","ECK3305-JW3280","rplW",163,3444712,3445091,379,"50M","False","f"
"7712","ECK3304-JW3279","rplB",163,3443873,3444771,898,"50M","False","f"
"7714","ECK3303-JW3278","rpsS",163,3443578,3443933,355,"50M","False","f"
"7716","ECK3302-JW3277","rplV",163,3443231,3443640,409,"50M","False","f"
"7718","ECK3301-JW3276","rpsC",163,3442512,3443290,778,"50M","False","f"
"7720","ECK3300-JW3275","rplP",163,3442089,3442576,487,"50M","False","f"
"7722","ECK3299-JW3274","rpmC",163,3441898,3442166,268,"50M","False","f"
"7724","ECK3298-JW3273","rpsQ",163,3441644,3441975,331,"50M","False","f"
"7726","ECK3297-JW3272","rplN",163,3441108,3441556,448,"50M","False","f"
"7728","ECK3296-JW3271","rplX",163,3440783,3441174,391,"50M","False","f"
"7730","ECK3295-JW3270","rplE",163,3440229,3440845,616,"50M","False","f"
"7732","ECK3294-JW3269","rpsN",163,3439909,3440291,382,"50M","False","f"
"7734","ECK3293-JW3268","rpsH",163,3439483,3439952,469,"50M","False","f"
"7736","ECK3292-JW3267","rplF",163,3438937,3439547,610,"50M","False","f"
"7738","ECK3291-JW3266","rplR",163,3438574,3439004,430,"50M","False","f"
"7740","ECK3290-JW3265","rpsE",163,3438056,3438636,580,"50M","False","f"
"7742","ECK3289-JW3264","rpmD",163,3437873,3438129,256,"50M","False","f"
"7744","ECK3288-JW3263","rplO",163,3437435,3437946,511,"50M","False","f"
"7746","ECK3287-JW3262","secY",163,3436096,3437504,1408,"50M","False","f"
"7748","ECK3286-JW3261","rpmJ",163,3435948,3436141,193,"50M","False","f"
"7750","ECK3285-JW3260","rpsM",163,3435445,3435878,433,"50M","False","f"
"7752","ECK3284-JW3259","rpsK",163,3435039,3435505,466,"50M","False","f"
"7754","ECK3283-JW3258","rpsD",163,3434385,3435082,697,"50M","False","f"
"7756","ECK3282-JW3257","rpoA",163,3433370,3434436,1066,"50M","False","f"
"7758","ECK3281-JW3256","rplQ",163,3432946,3433406,460,"50M","False","f"
"7760","ECK3280-JW3255","yhdN",163,3432471,3432916,445,"50M","False","f"
"7762","ECK3279-JW3254","zntR",163,3432035,3432537,502,"50M","False","f"
"7764","ECK3278-JW3253","yhdL",163,3431761,3432056,295,"50M","False","f"
"7766","ECK3277-JW3252","mscL",163,3431336,3431823,487,"50M","False","r"
"7768","ECK3276-JW3251","trkA",163,3429830,3431283,1453,"50M","False","r"
"7770","ECK3275-JW3250","rsmB",163,3428519,3429885,1366,"50M","False","r"
"7772","ECK3274-JW3249","fmt",163,3427526,3428550,1024,"50M","False","r"
"7774","ECK3273-JW3248","def",163,3427002,3427588,586,"50M","False","r"
"7776","ECK3272-JW5708","smf",163,3425766,3426967,1201,"50M","False","f"
"7778","ECK3271-JW3245","smg",163,3425321,3425871,550,"50M","False","f"
"7780","ECK3270-JW5949","yrdD",163,3424750,3425132,382,"50M","False","f"
"7782","ECK3269-JW3243","yrdC",163,3424173,3424822,649,"50M","False","f"
"7784","ECK3268-JW3242","aroE",163,3423350,3424245,895,"50M","False","f"
"7786","ECK3267-JW3241","yrdB",163,3423096,3423430,334,"50M","False","f"
"7788","ECK3266-JW5710","yrdA",163,3422548,3423179,631,"50M","False","r"
"7789","ECK4003-JW3971","yjaA",99,4203165,4203525,360,"50M","False","f"
"7791","ECK4004-JW3972","yjaB",99,4203629,4204049,420,"50M","False","r"
"7793","ECK4005-JW3973","metA",99,4204211,4205117,906,"50M","False","f"
"7795","ECK4006-JW3974","aceB",99,4205409,4206987,1578,"50M","False","f"
"7797","ECK4007-JW3975","aceA",99,4207040,4208321,1281,"50M","False","f"
"7799","ECK4008-JW3976","aceK",99,4208527,4210240,1713,"50M","False","f"
"7801","ECK4009-JW3977","arpA",99,4210250,4212413,2163,"50M","False","r"
"7803","ECK4010-JW3978","iclR",99,4212753,4213554,801,"50M","False","r"
"7805","ECK4011-JW3979","metH",97,4213759,4217419,3660,"50M","False","f"
"7807","ECK4012-JW3980","yjbB",99,4217662,4219270,1608,"50M","False","f"
"7809","ECK4013-JW3981","pepE",99,4219402,4220068,666,"50M","False","r"
"7811","ECK4014-JW3982","yjbC",99,4220285,4221134,849,"50M","False","f"
"7813","ECK4015-JW3983","yjbD",99,4221308,4221557,249,"50M","False","r"
"7815","ECK4016-JW3984","lysC",99,4221833,4223159,1326,"50M","False","r"
"7817","ECK4017-JW3985","pgi",99,4223689,4225315,1626,"50M","False","f"
"7819","ECK4018-JW3986","yjbE",99,4225837,4226056,219,"50M","False","f"
"7821","ECK4019-JW5711","yjbF",99,4226193,4226808,615,"50M","False","f"
"7823","ECK4020-JW3988","yjbG",99,4226828,4227542,714,"50M","False","f"
"7825","ECK4021-JW3989","yjbH",99,4227565,4229638,2073,"50M","False","f"
"7827","ECK4022-JW3990","yjbA",99,4230256,4230643,387,"50M","False","f"
"7829","ECK4023-JW3991","xylE",99,4230728,4232180,1452,"50M","False","r"
"7831","ECK4024-JW3992","malG",99,4232575,4233442,867,"50M","False","r"
"7833","ECK4025-JW3993","malF",99,4233480,4235001,1521,"50M","False","r"
"7835","ECK4026-JW3994","malE",99,4235178,4236345,1167,"50M","False","r"
"7837","ECK4027-JW3995","malK",99,4236715,4237807,1092,"50M","False","f"
"7839","ECK4028-JW3996","lamB",99,4237902,4239219,1317,"50M","False","f"
"7841","ECK4029-JW3997","malM",99,4239485,4240382,897,"50M","False","f"
"7843","none-JW5712","none",99,4240634,4240805,171,"50M","False","f"
"7845","ECK4030-JW3998","yjbI",99,4240886,4242191,1305,"50M","False","f"
"7847","ECK4031-JW5713","ubiC",99,4242437,4242911,474,"50M","False","f"
"7849","ECK4032-JW4000","ubiA",99,4242947,4243796,849,"50M","False","f"
"7851","ECK4033-JW4001","plsB",99,4243992,4246392,2400,"50M","False","r"
"7853","ECK4034-JW4002","dgkA",99,4246568,4246913,345,"50M","False","f"
"7855","ECK4035-JW4003","lexA",99,4247046,4247631,585,"50M","False","f"
"7857","ECK4036-JW4004","dinF",99,4247673,4249029,1356,"50M","False","f"
"7859","ECK4037-JW4005","yjbJ",99,4249168,4249354,186,"50M","False","f"
"7861","ECK4038-JW5714","zur",99,4249437,4249929,492,"50M","False","r"
"7863","ECK4039-JW4007","yjbL",99,4250252,4250483,231,"50M","False","f"
"7865","ECK4040-JW4008","yjbM",99,4250530,4251214,684,"50M","False","f"
"7867","ECK4041-JW5950","yjbN",99,4251645,4252614,969,"50M","False","f"
"7869","ECK4042-JW5716","yjbO",99,4252771,4252990,219,"50M","False","f"
"7871","ECK4043-JW4011","qor",99,4253197,4254157,960,"50M","False","r"
"7873","ECK4044-JW4012","dnaB",99,4254245,4255637,1392,"50M","False","f"
"7875","ECK4045-JW4013","alr",99,4255713,4256769,1056,"50M","False","f"
"7877","ECK4046-JW4014","tyrB",99,4257045,4258215,1170,"50M","False","f"
"7879","none-JW5717","none",99,4258758,4258938,180,"50M","False","r"
"7881","ECK4047-JW4015","aphA",99,4259345,4260035,690,"50M","False","f"
"7883","none-JW4016","none",99,4259804,4260008,204,"50M","False","r"
"7885","ECK4048-JW4017","yjbQ",99,4260169,4260562,393,"50M","False","f"
"7887","ECK4049-JW4018","yjbR",99,4260589,4260922,333,"50M","False","f"
"7889","ECK4050-JW4019","uvrA",99,4260998,4263797,2799,"50M","False","r"
"7891","ECK4051-JW4020","ssb",99,4264056,4264569,513,"50M","False","f"
"7893","ECK4052-JW5718","yjcB",99,4264709,4264967,258,"50M","False","r"
"7895","ECK4053-JW4022","yjcC",99,4265402,4266965,1563,"50M","False","f"
"7897","ECK4054-JW4023","soxS",99,4267009,4267309,300,"50M","False","r"
"7899","ECK4055-JW4024","soxR",99,4267400,4267841,441,"50M","False","f"
"7901","ECK4057-JW4025","yjcD",99,4268410,4269736,1326,"50M","False","f"
"7903","ECK4058-JW4026","yjcE",99,4269911,4271537,1626,"50M","False","f"
"7905","ECK4059-JW4027","yjcF",99,4271732,4273001,1269,"50M","False","r"
"7907","ECK4060-JW4028","actP",99,4273202,4274828,1626,"50M","False","r"
"7909","ECK4061-JW4029","yjcH",99,4274848,4275139,291,"50M","False","r"
"7911","ECK4062-JW4030","acs",99,4275362,4277297,1935,"50M","False","r"
"7913","none-JW5719","none",99,4277413,4277575,162,"50M","False","f"
"7915","ECK4063-JW4031","nrfA",99,4277695,4279108,1413,"50M","False","f"
"7917","ECK4064-JW4032","nrfB",99,4279176,4279719,543,"50M","False","f"
"7919","ECK4065-JW4033","nrfC",99,4279739,4280387,648,"50M","False","f"
"7921","ECK4066-JW4034","nrfD",99,4280407,4281340,933,"50M","False","f"
"7923","ECK4067-JW4035","nrfE",99,4281443,4283078,1635,"50M","False","f"
"7925","ECK4068-JW4036","nrfF",99,4283094,4283454,360,"50M","False","f"
"7927","ECK4069-JW4037","nrfG",99,4283474,4284047,573,"50M","False","f"
"7929","ECK4070-JW4038","gltP",99,4284412,4285702,1290,"50M","False","f"
"7931","ECK4071-JW4039","yjcO",99,4286274,4286940,666,"50M","False","r"
"7933","ECK4072-JW4040","fdhF",99,4287057,4289181,2124,"50M","False","r"
"7935","ECK4073-JW4041","yjcP",99,4289402,4290845,1443,"50M","False","r"
"7937","ECK4074-JW4042","yjcQ",99,4290865,4292893,2028,"50M","False","r"
"7939","ECK4075-JW4043","yjcR",99,4292916,4293924,1008,"50M","False","r"
"7941","none-JW5720","none",99,4293966,4294218,252,"50M","False","r"
"7943","ECK4076-JW5721","yjcS",99,4294450,4296412,1962,"50M","False","r"
"7947","ECK4078-JW4046","alsE",99,4297621,4298293,672,"50M","False","r"
"7949","ECK4079-JW4047","alsC",99,4298327,4299284,957,"50M","False","r"
"7951","ECK4080-JW4048","alsA",99,4299286,4300795,1509,"50M","False","r"
"7953","ECK4081-JW4049","alsB",99,4300945,4301857,912,"50M","False","r"
"7955","ECK4082-JW4050","rpiR",99,4301939,4302806,867,"50M","False","r"
"7957","ECK4083-JW4051","rpiB",99,4303170,4303596,426,"50M","False","f"
"7959","none-JW5725","none",99,4303648,4303774,126,"50M","False","r"
"7961","none-JW5726","none",99,4303730,4304033,303,"50M","False","r"
"7963","ECK4085-JW4053","phnP",99,4304182,4304917,735,"50M","False","r"
"7965","ECK4086-JW4054","phnO",99,4304942,4305353,411,"50M","False","r"
"7967","ECK4087-JW4055","phnN",99,4305363,4305897,534,"50M","False","r"
"7969","ECK4088-JW4056","phnM",99,4305920,4307033,1113,"50M","False","r"
"7971","ECK4089-JW4057","phnL",99,4307053,4307710,657,"50M","False","r"
"7973","ECK4090-JW5727","phnK",99,4307844,4308579,735,"50M","False","r"
"7975","ECK4091-JW4059","phnJ",99,4308599,4309421,822,"50M","False","r"
"7977","ECK4092-JW4060","phnI",99,4309437,4310478,1041,"50M","False","r"
"7979","ECK4093-JW4061","phnH",99,4310501,4311062,561,"50M","False","r"
"7981","ECK4094-JW4062","phnG",99,4311082,4311511,429,"50M","False","r"
"7983","ECK4095-JW4063","phnF",99,4311535,4312237,702,"50M","False","r"
"7985","ECK4096-JW4064","phnE",99,4312281,4312626,345,"50M","False","r"
"7987","ECK4097-JW4065","phnE",99,4312499,4313096,597,"50M","False","r"
"7989","ECK4098-JW4066","phnD",99,4313174,4314167,993,"50M","False","r"
"7991","ECK4099-JW4067","phnC",99,4314215,4314980,765,"50M","False","r"
"7993","ECK4100-JW4068","phnB",99,4315136,4315556,420,"50M","False","r"
"7995","ECK4101-JW4069","phnA",99,4316237,4316549,312,"50M","False","r"
"7997","none-JW5728","none",99,4316553,4316715,162,"50M","False","f"
"7999","ECK4102-JW4070","yjdA",99,4316955,4319160,2205,"50M","False","f"
"8001","ECK4103-JW5729","yjcZ",99,4319180,4320035,855,"50M","False","f"
"8003","ECK4104-JW4072","proP",99,4320322,4321801,1479,"50M","False","f"
"8005","ECK4105-JW4073","basS",99,4322019,4323087,1068,"50M","False","r"
"8007","ECK4106-JW4074","basR",99,4323120,4323765,645,"50M","False","r"
"8009","ECK4107-JW5730","eptA",99,4323785,4325405,1620,"50M","False","r"
"8011","ECK4108-JW4076","adiC",99,4325532,4326846,1314,"50M","False","r"
"8013","ECK4109-JW4077","adiY",99,4327006,4327744,738,"50M","False","r"
"8015","ECK4110-JW5731","adiA",99,4328092,4330339,2247,"50M","False","r"
"8017","ECK4111-JW4079","melR",99,4330558,4331443,885,"50M","False","r"
"8019","ECK4112-JW4080","melA",99,4331731,4333063,1332,"50M","False","f"
"8021","ECK4113-JW4081","melB",99,4333201,4334587,1386,"50M","False","f"
"8023","ECK4114-JW4082","yjdF",99,4334767,4335373,606,"50M","False","r"
"8025","ECK4115-JW4083","fumB",99,4335518,4337141,1623,"50M","False","r"
"8027","ECK4116-JW4084","dcuB",99,4337242,4338559,1317,"50M","False","r"
"8029","ECK4117-JW4085","dcuR",99,4339153,4339849,696,"50M","False","r"
"8031","ECK4118-JW4086","dcuS",99,4339869,4341477,1608,"50M","False","r"
"8033","ECK4119-JW4087","yjdI",99,4341663,4341870,207,"50M","False","f"
"8035","ECK4120-JW4088","yjdJ",99,4341905,4342154,249,"50M","False","f"
"8037","ECK4121-JW4089","yjdK",99,4342404,4342677,273,"50M","False","f"
"8039","ECK4122-JW5732","yjdO",99,4342728,4342878,150,"50M","False","f"
"8041","ECK4123-JW4090","lysU",99,4343038,4344532,1494,"50M","False","r"
"8043","ECK4124-JW4091","yjdL",99,4344792,4346226,1434,"50M","False","r"
"8045","ECK4125-JW4092","cadA",99,4346308,4348432,2124,"50M","False","r"
"8047","ECK4126-JW4093","cadB",99,4348535,4349846,1311,"50M","False","r"
"8049","ECK4127-JW4094","cadC",99,4350234,4351749,1515,"50M","False","r"
"8051","ECK4129-JW5733","yjdC",99,4352571,4353123,552,"50M","False","r"
"8053","ECK4130-JW5734","dipZ",99,4353183,4354857,1674,"50M","False","r"
"8055","ECK4131-JW4097","cutA",99,4354856,4355171,315,"50M","False","r"
"8057","ECK4132-JW5735","dcuA",99,4355310,4356402,1092,"50M","False","r"
"8059","ECK4133-JW4099","aspA",99,4356729,4358142,1413,"50M","False","r"
"8061","ECK4134-JW4100","fxsA",99,4358484,4358937,453,"50M","False","f"
"8063","ECK4135-JW4101","yjeH",99,4358994,4360227,1233,"50M","False","r"
"8065","ECK4136-JW4102","groS",99,4360508,4360778,270,"50M","False","f"
"8067","ECK4137-JW4103","groL",99,4360845,4362468,1623,"50M","False","f"
"8069","ECK4138-JW5736","yjeI",99,4362629,4362959,330,"50M","False","f"
"8071","ECK4139-JW4105","yjeJ",99,4363203,4364049,846,"50M","False","r"
"8073","ECK4140-JW4106","yjeK",99,4364467,4365472,1005,"50M","False","r"
"8075","ECK4141-JW4107","efp",99,4365519,4366062,543,"50M","False","f"
"8077","ECK4142-JW5737","ecnA",99,4366137,4366239,102,"50M","False","f"
"8079","ECK4143-JW4108","ecnB",99,4366373,4366496,123,"50M","False","f"
"8081","ECK4144-JW5738","sugE",99,4366695,4366989,294,"50M","False","f"
"8083","ECK4145-JW4110","blc",99,4367027,4367537,510,"50M","False","r"
"8085","ECK4146-JW4111","ampC",99,4367649,4368759,1110,"50M","False","r"
"8087","ECK4147-JW4112","frdD",99,4368845,4369181,336,"50M","False","r"
"8089","ECK4148-JW4113","frdC",99,4369215,4369587,372,"50M","False","r"
"8091","ECK4149-JW4114","frdB",99,4369621,4370332,711,"50M","False","r"
"8093","ECK4150-JW4115","frdA",99,4370348,4372133,1785,"50M","False","r"
"8095","ECK4151-JW4116","poxA",99,4372463,4373417,954,"50M","False","f"
"8097","ECK4152-JW5739","yjeM",99,4373659,4375138,1479,"50M","False","f"
"8099","ECK4153-JW4118","yjeN",99,4375213,4375504,291,"50M","False","f"
"8101","ECK4154-JW4119","yjeO",99,4375524,4375815,291,"50M","False","f"
"8103","ECK4155-JW4120","yjeP",99,4375885,4379185,3300,"50M","False","r"
"8105","ECK4156-JW4121","psd",99,4379230,4380175,945,"50M","False","r"
"8107","ECK4157-JW4122","rsgA",99,4380295,4381324,1029,"50M","False","r"
"8109","ECK4158-JW5740","orn",99,4381424,4381946,522,"50M","False","f"
"8111","ECK4162-JW4124","yjeS",99,4382766,4383882,1116,"50M","False","r"
"8113","ECK4163-JW4125","yjeF",99,4383886,4385383,1497,"50M","False","f"
"8115","ECK4164-JW4126","yjeE",99,4385405,4385843,438,"50M","False","f"
"8117","ECK4165-JW4127","amiB",99,4385885,4387199,1314,"50M","False","f"
"8119","ECK4166-JW4128","mutL",99,4387232,4389056,1824,"50M","False","f"
"8121","ECK4167-JW4129","miaA",99,4389072,4389999,927,"50M","False","f"
"8123","ECK4168-JW4130","hfq",99,4390108,4390393,285,"50M","False","f"
"8125","ECK4169-JW4131","hflX",99,4390492,4391749,1257,"50M","False","f"
"8127","ECK4170-JW4132","hflK",99,4391858,4393094,1236,"50M","False","f"
"8129","ECK4171-JW4133","hflC",99,4393120,4394101,981,"50M","False","f"
"8131","ECK4172-JW4134","yjeT",99,4394206,4394380,174,"50M","False","f"
"8133","ECK4173-JW4135","purA",99,4394507,4395782,1275,"50M","False","f"
"8135","ECK4174-JW4136","yjeB",99,4396010,4396412,402,"50M","False","f"
"8137","ECK4175-JW5741","rnr",99,4396474,4398892,2418,"50M","False","f"
"8139","ECK4176-JW4138","rlmB",99,4399095,4399803,708,"50M","False","f"
"8141","ECK4177-JW4139","yjfI",99,4399953,4400331,378,"50M","False","f"
"8143","ECK4178-JW4140","yjfJ",99,4400373,4401048,675,"50M","False","f"
"8145","ECK4179-JW4141","yjfK",99,4401122,4401758,636,"50M","False","f"
"8147","ECK4180-JW4142","yjfL",99,4401799,4402174,375,"50M","False","f"
"8149","ECK4181-JW4143","yjfM",99,4402207,4402822,615,"50M","False","f"
"8151","ECK4182-JW4144","yjfC",99,4402848,4403988,1140,"50M","False","f"
"8153","ECK4183-JW5867","aidB",99,4404080,4405697,1617,"50M","False","f"
"8155","ECK4184-JW5742","yjfN",99,4405855,4406107,252,"50M","False","r"
"8157","ECK4185-JW5743","yjfO",99,4406279,4406585,306,"50M","False","r"
"8159","ECK4186-JW4148","yjfP",99,4406772,4407498,726,"50M","False","f"
"8161","ECK4187-JW4149","ulaR",99,4407536,4408268,732,"50M","False","r"
"8163","ECK4188-JW5868","ulaG",99,4408399,4409446,1047,"50M","False","r"
"8165","ECK4189-JW5744","ulaA",99,4409800,4411174,1374,"50M","False","f"
"8167","ECK4190-JW4152","ulaB",99,4411213,4411495,282,"50M","False","f"
"8169","ECK4191-JW4153","ulaC",99,4411528,4411969,441,"50M","False","f"
"8171","ECK4192-JW4154","ulaD",99,4412006,4412633,627,"50M","False","f"
"8173","ECK4193-JW4155","ulaE",99,4412666,4413497,831,"50M","False","f"
"8175","ECK4194-JW4156","ulaF",99,4413520,4414183,663,"50M","False","f"
"8177","ECK4195-JW4157","yjfY",99,4414354,4414606,252,"50M","False","r"
"8179","ECK4196-JW4158","rpsF",99,4414938,4415310,372,"50M","False","f"
"8181","ECK4197-JW4159","priB",99,4415340,4415631,291,"50M","False","f"
"8183","ECK4198-JW4160","rpsR",99,4415659,4415863,204,"50M","False","f"
"8185","ECK4199-JW4161","rplI",99,4415928,4416354,426,"50M","False","f"
"8187","ECK4200-JW4162","yjfZ",99,4416466,4417237,771,"50M","False","r"
"8189","ECK4201-JW4163","ytfA",99,4417589,4417892,303,"50M","False","f"
"8191","ECK4202-JW5745","ytfB",99,4417917,4418532,615,"50M","False","r"
"8193","ECK4203-JW5746","fklB",99,4418755,4419352,597,"50M","False","f"
"8195","ECK4204-JW4166","cycA",99,4419684,4421073,1389,"50M","False","f"
"8197","ECK4205-JW4167","ytfE",99,4421159,4421798,639,"50M","False","r"
"8199","ECK4206-JW4168","ytfF",99,4421929,4422880,951,"50M","False","r"
"8201","ECK4207-JW4169","ytfG",99,4423002,4423839,837,"50M","False","r"
"8203","ECK4208-JW5747","ytfH",99,4423933,4424290,357,"50M","False","f"
"8205","ECK4209-JW4171","cpdB",99,4424460,4426380,1920,"50M","False","r"
"8207","ECK4210-JW4172","cysQ",99,4426575,4427292,717,"50M","False","f"
"8209","ECK4211-JW5748","ytfI",99,4427527,4428442,915,"50M","False","f"
"8211","ECK4212-JW4175","ytfJ",99,4428546,4429077,531,"50M","False","r"
"8213","ECK4213-JW5749","ytfK",99,4429407,4429590,183,"50M","False","f"
"8215","ECK4214-JW4177","ytfL",99,4429710,4431030,1320,"50M","False","r"
"8217","ECK4215-JW4178","msrA",99,4431376,4431991,615,"50M","False","r"
"8219","ECK4216-JW4179","ytfM",99,4432202,4433912,1710,"50M","False","f"
"8221","ECK4217-JW4180","ytfN",97,4433932,4437688,3756,"50M","False","f"
"8223","ECK4218-JW4181","ytfP",99,4437714,4438032,318,"50M","False","f"
"8225","ECK4219-JW4182","yzfA",99,4437814,4438060,246,"50M","False","r"
"8227","ECK4220-JW5750","chpS",99,4438267,4438495,228,"50M","False","f"
"8229","ECK4221-JW4184","chpB",99,4438512,4438839,327,"50M","False","f"
"8231","ECK4222-JW4185","ppa",99,4438960,4439467,507,"50M","False","r"
"8233","none-JW5751","none",99,4439502,4439604,102,"50M","False","r"
"8235","ECK4223-JW4186","ytfQ",99,4439782,4440715,933,"50M","False","f"
"8237","ECK4224-JW5752","ytfR",99,4440878,4442357,1479,"50M","False","f"
"8239","ECK4225-JW5753","ytfT",99,4442394,4443393,999,"50M","False","f"
"8241","ECK4226-JW5754","yjfF",99,4443403,4444375,972,"50M","False","f"
"8243","ECK4227-JW4191","fbp",99,4444449,4445424,975,"50M","False","r"
"8245","ECK4228-JW4192","mpl",99,4445605,4446955,1350,"50M","False","f"
"8247","ECK4229-JW4193","yjgA",99,4447152,4447680,528,"50M","False","r"
"8249","ECK4230-JW4194","pmbA",99,4447779,4449108,1329,"50M","False","f"
"8251","ECK4231-JW4195","cybC",99,4449373,4449652,279,"50M","False","f"
"8253","ECK4232-JW4196","nrdG",99,4449738,4450179,441,"50M","False","r"
"8255","ECK4233-JW4197","nrdD",99,4450360,4452475,2115,"50M","False","r"
"8257","ECK4234-JW4198","treC",99,4452892,4454524,1632,"50M","False","r"
"8259","ECK4235-JW4199","treB",99,4454597,4455995,1398,"50M","False","r"
"8261","ECK4236-JW4200","treR",99,4456137,4457061,924,"50M","False","r"
"8263","ECK4237-JW4201","mgtA",99,4457445,4460118,2673,"50M","False","f"
"8265","ECK4238-JW5755","yjgF",99,4460365,4460728,363,"50M","False","r"
"8267","ECK4239-JW4203","pyrI",99,4460824,4461262,438,"50M","False","r"
"8269","ECK4240-JW4204","pyrB",99,4461298,4462210,912,"50M","False","r"
"8271","ECK4241-JW4205","pyrL",99,4462237,4462348,111,"50M","False","r"
"8273","ECK4242-JW4206","yjgH",99,4462652,4463024,372,"50M","False","r"
"8275","ECK4243-JW4207","yjgI",99,4463178,4463868,690,"50M","False","r"
"8277","ECK4244-JW4208","yjgJ",99,4463944,4464514,570,"50M","False","f"
"8279","ECK4245-JW5756","yjgK",99,4464682,4465111,429,"50M","False","f"
"8281","ECK4246-JW5757","yjgL",99,4465257,4467048,1791,"50M","False","f"
"8283","ECK4247-JW4211","argI",99,4467173,4468126,953,"28S22M","False","r"
"8285","ECK4248-JW4212","yjgD",99,4468293,4468686,393,"50M","False","f"
"8287","ECK4249-JW5758","yjgM",99,4468872,4469352,480,"50M","False","r"
"8289","ECK4250-JW5759","yjgN",99,4469550,4470723,1173,"50M","False","f"
"8291","ECK4251-JW4215","valS",99,4470821,4473652,2831,"6M1I43M","False","r"
"8293","ECK4252-JW4216","holC",99,4473675,4474095,420,"50M","False","r"
"8295","ECK4253-JW4217","pepA",99,4474278,4475766,1488,"50M","False","r"
"8297","ECK4254-JW4218","yjgP",99,4476038,4477115,1077,"50M","False","f"
"8299","ECK4255-JW5760","yjgQ",99,4477138,4478197,1059,"50M","False","f"
"8301","ECK4256-JW4220","yjgR",99,4478399,4479878,1479,"50M","False","r"
"8303","ECK4257-JW4221","idnR",99,4479979,4480954,975,"50M","False","r"
"8305","ECK4258-JW4222","idnT",99,4481044,4482340,1296,"50M","False","r"
"8307","ECK4259-JW4223","idnO",99,4482425,4483166,741,"50M","False","r"
"8309","ECK4260-JW4224","idnD",99,4483213,4484221,1008,"50M","False","r"
"8311","ECK4261-JW4225","idnK",99,4484443,4484983,540,"50M","False","f"
"8313","ECK4262-JW5761","yjgB",99,4485028,4486024,996,"50M","False","r"
"8315","ECK4264-JW4227","intB",99,4486570,4487737,1167,"50M","False","f"
"8317","ECK4265-JW4233","yjgW",99,4489419,4489731,312,"50M","False","f"
"8319","ECK4266-JW5763","yjgX",99,4489515,4489734,219,"50M","False","r"
"8321","ECK4266-JW4234","yjgX",99,4489881,4490304,423,"50M","False","r"
"8323","ECK4266-JW5764","yjgX",99,4490270,4490606,336,"50M","False","r"
"8325","none-JW5765","none",99,4490626,4490833,207,"50M","False","r"
"8327","ECK4267-JW4236","yjgZ",99,4491080,4491386,306,"50M","False","f"
"8329","none-JW5766","none",99,4491752,4491872,120,"50M","False","f"
"8331","ECK4269-JW5768","yjhB",99,4493878,4495072,1194,"50M","False","f"
"8333","ECK4270-JW5769","yjhC",99,4495107,4496202,1095,"50M","False","f"
"8335","ECK4271-JW5770","yjhD",99,4496464,4496671,207,"50M","False","r"
"8337","ECK4272-JW4242","yjhE",99,4496681,4496906,225,"50M","False","f"
"8339","ECK4276-JW4246","yjhV",99,4499540,4499930,390,"50M","False","f"
"8341","ECK4277-JW4247","fecE",99,4500528,4501272,744,"50M","False","r"
"8343","ECK4278-JW4248","fecD",99,4501296,4502229,933,"50M","False","r"
"8345","ECK4279-JW4249","fecC",99,4502249,4503224,975,"50M","False","r"
"8347","ECK4280-JW4250","fecB",99,4503244,4504123,879,"50M","False","r"
"8349","ECK4281-JW4251","fecA",99,4504191,4506492,2301,"50M","False","r"
"8351","ECK4282-JW4252","fecR",99,4506605,4507532,927,"50M","False","r"
"8353","ECK4283-JW4253","fecI",99,4507555,4508050,495,"50M","False","r"
"8355","ECK4284-JW5952","yjhU",99,4509176,4510031,855,"50M","False","r"
"8357","ECK4285-JW4258","yjhF",99,4510509,4511835,1326,"50M","False","r"
"8359","ECK4286-JW4259","yjhG",99,4511965,4513909,1944,"50M","False","r"
"8361","ECK4287-JW5775","yjhH",99,4513943,4514825,882,"50M","False","r"
"8363","ECK4288-JW4261","yjhI",99,4514853,4515618,765,"50M","False","r"
"8365","ECK4289-JW4262","sgcR",99,4515944,4516703,759,"50M","False","r"
"8367","ECK4290-JW4263","sgcE",99,4516743,4517352,609,"50M","False","r"
"8369","ECK4291-JW4264","sgcA",99,4517387,4517795,408,"50M","False","r"
"8371","ECK4292-JW4265","sgcQ",99,4517949,4518732,783,"50M","False","r"
"8373","ECK4293-JW4266","sgcC",99,4518768,4520058,1290,"50M","False","r"
"8375","ECK4294-JW5967","sgcB",99,4520093,4520348,255,"50M","False","r"
"8377","ECK4295-JW5776","sgcX",99,4520368,4521496,1128,"50M","False","r"
"8379","ECK4296-JW4268","yjhP",99,4522275,4522998,723,"50M","False","r"
"8381","ECK4297-JW4269","yjhQ",99,4523077,4523599,522,"50M","False","r"
"8383","ECK4298-JW5968","yjhX",99,4523634,4523868,234,"50M","False","r"
"8385","ECK4299-JW4271","yjhR",99,4524835,4525828,993,"50M","False","f"
"8387","ECK4300-JW4272","yjhS",99,4526452,4527409,957,"50M","False","r"
"8389","ECK4301-JW5777","yjhT",99,4527497,4528580,1083,"50M","False","r"
"8391","ECK4302-JW5778","yjhA",99,4528623,4529316,693,"50M","False","r"
"8393","ECK4303-JW4275","fimB",99,4530777,4531356,579,"50M","False","f"
"8395","ECK4304-JW4276","fimE",99,4531857,4532430,573,"50M","False","f"
"8397","ECK4305-JW4277","fimA",99,4532935,4533460,525,"50M","False","f"
"8399","ECK4306-JW5779","fimI",99,4533548,4534064,516,"50M","False","f"
"8401","ECK4307-JW4279","fimC",99,4534124,4534826,702,"50M","False","f"
"8403","ECK4308-JW5780","fimD",99,4534917,4537529,2612,"22M1I27M","False","f"
"8405","ECK4309-JW4281","fimF",99,4537562,4538069,507,"50M","False","f"
"8407","ECK4310-JW4282","fimG",99,4538105,4538585,480,"50M","False","f"
"8409","ECK4311-JW4283","fimH",99,4538628,4539507,879,"50M","False","f"
"8411","ECK4312-JW4284","gntP",99,4539791,4541111,1320,"50M","False","r"
"8413","ECK4313-JW4285","uxuA",99,4541456,4542617,1161,"50M","False","f"
"8415","ECK4314-JW4286","uxuB",99,4542721,4544158,1437,"50M","False","f"
"8417","none-JW5781","none",99,4544221,4544392,171,"50M","False","r"
"8419","ECK4315-JW4287","uxuR",99,4544396,4545146,750,"50M","False","f"
"8421","ECK4316-JW4288","yjiC",99,4545328,4546135,807,"50M","False","r"
"8423","ECK4317-JW5782","yjiD",99,4546813,4547182,369,"50M","False","f"
"8425","ECK4318-JW4290","yjiE",99,4547216,4548104,888,"50M","False","r"
"8427","ECK4319-JW4291","iadA",99,4548192,4549341,1149,"50M","False","r"
"8429","ECK4320-JW4292","yjiG",99,4549377,4549815,438,"50M","False","r"
"8431","ECK4321-JW5783","yjiH",99,4549835,4550495,660,"50M","False","r"
"8433","ECK4322-JW5784","kptA",99,4550750,4551281,531,"50M","False","f"
"8435","ECK4323-JW4295","yjiJ",99,4551335,4552490,1155,"50M","False","r"
"8437","ECK4324-JW5869","yjiK",99,4552581,4553529,948,"50M","False","r"
"8439","none-JW4296","none",99,4553506,4553740,234,"50M","False","r"
"8441","ECK4325-JW5785","yjiL",99,4553760,4554504,744,"50M","False","r"
"8443","ECK4326-JW5786","yjiM",99,4554537,4555665,1128,"50M","False","r"
"8445","ECK4327-JW4299","yjiN",99,4555804,4557061,1257,"50M","False","r"
"8447","ECK4328-JW4300","yjiO",99,4557125,4558334,1209,"50M","False","r"
"8449","ECK4329-JW5953","yjiP",99,4558818,4559106,288,"50M","False","f"
"8451","ECK4330-JW4302","yjiQ",99,4559178,4559715,537,"50M","False","f"
"8453","ECK4331-JW4303","yjiR",99,4560000,4561389,1389,"50M","False","r"
"8455","ECK4332-JW4304","yjiS",99,4561571,4561712,141,"50M","False","f"
"8457","ECK4333-JW5787","yjiT",99,4562234,4563728,1494,"50M","False","f"
"8459","ECK4334-JW5954","yjiV",99,4564339,4566652,2313,"50M","False","f"
"8461","ECK4335-JW5789","mcrC",99,4566750,4567773,1023,"50M","False","r"
"8463","ECK4336-JW5871","mcrB",99,4567796,4569170,1374,"50M","False","r"
"8465","ECK4337-JW4310","yjiW",99,4569337,4569712,375,"50M","False","r"
"8467","ECK4338-JW4311","hsdS",99,4569906,4571277,1371,"50M","False","r"
"8469","ECK4339-JW4312","hsdM",99,4571297,4572863,1566,"50M","False","r"
"8471","ECK4340-JW4313","hsdR",97,4573087,4576630,3543,"50M","False","r"
"8473","ECK4341-JW4314","mrr",99,4576769,4577660,891,"50M","False","f"
"8475","ECK4342-JW5790","yjiA",99,4577747,4578680,933,"50M","False","r"
"8477","ECK4343-JW4316","yjiX",99,4578714,4578894,180,"50M","False","r"
"8479","ECK4344-JW5791","yjiY",99,4578967,4581094,2127,"50M","False","r"
"8481","ECK4345-JW4318","tsr",99,4581477,4583109,1632,"50M","False","f"
"8483","ECK4346-JW4319","yjiZ",99,4583199,4584537,1338,"50M","False","r"
"8485","ECK4347-JW5792","yjjM",99,4584775,4585666,891,"50M","False","r"
"8487","ECK4348-JW5793","yjjN",99,4585810,4586809,999,"50M","False","f"
"8489","ECK4349-JW5794","mdoB",99,4586988,4589256,2268,"50M","False","r"
"8491","ECK4350-JW5795","yjjA",99,4589533,4590004,471,"50M","False","r"
"8493","ECK4351-JW4325","dnaC",99,4590076,4590790,714,"50M","False","r"
"8495","ECK4352-JW4326","dnaT",99,4590816,4591332,516,"50M","False","r"
"8497","ECK4353-JW4327","yjjB",99,4591462,4591765,303,"50M","False","r"
"8499","ECK4354-JW5796","yjjP",99,4591926,4592673,747,"50M","False","r"
"8501","ECK4355-JW4329","yjjQ",99,4593297,4593999,702,"50M","False","f"
"8503","ECK4356-JW5955","bglJ",99,4593980,4594634,654,"50M","False","f"
"8505","ECK4357-JW4331","fhuF",99,4594713,4595478,765,"50M","False","r"
"8507","ECK4358-JW5797","yjjZ",99,4595624,4595837,213,"50M","False","f"
"8509","ECK4362-JW4333","rsmC",99,4596507,4597515,1008,"50M","False","r"
"8511","ECK4363-JW4334","holD",99,4597623,4598013,390,"50M","False","f"
"8513","ECK4364-JW4335","rimI",99,4598005,4598428,423,"50M","False","f"
"8515","ECK4365-JW4336","yjjG",99,4598466,4599120,654,"50M","False","f"
"8517","ECK4366-JW5873","prfC",99,4599207,4600800,1593,"50M","False","f"
"8519","ECK4367-JW4338","osmY",99,4601216,4601798,582,"50M","False","f"
"8521","ECK4369-JW4340","yjjU",99,4602231,4603281,1050,"50M","False","f"
"8523","ECK4370-JW4341","yjjV",99,4603301,4604057,756,"50M","False","f"
"8525","ECK4371-JW4342","yjjW",99,4604518,4605358,840,"50M","False","r"
"8527","ECK4372-JW4343","yjjI",99,4605353,4606880,1527,"50M","False","r"
"8529","none-JW5799","none",99,4606937,4607015,78,"50M","False","f"
"8531","ECK4373-JW4344","deoC",99,4607143,4607899,756,"50M","False","f"
"8533","ECK4374-JW4345","deoA",99,4608049,4609348,1299,"50M","False","f"
"8535","ECK4375-JW4346","deoB",99,4609423,4610623,1200,"50M","False","f"
"8537","ECK4376-JW4347","deoD",99,4610703,4611399,696,"50M","False","f"
"8539","ECK4377-JW4348","yjjJ",99,4611589,4612897,1308,"50M","False","f"
"8541","ECK4378-JW4349","lplA",99,4612939,4613932,993,"50M","False","r"
"8543","ECK4379-JW4350","ytjB",99,4613983,4614604,621,"50M","False","r"
"8545","ECK4380-JW4351","serB",99,4614715,4615660,945,"50M","False","f"
"8547","ECK4381-JW4352","radA",99,4615732,4617091,1359,"50M","False","f"
"8549","ECK4382-JW5800","nadR",99,4617114,4618344,1230,"50M","False","f"
"8551","ECK4383-JW4354","yjjK",99,4618693,4620337,1644,"50M","False","r"
"8553","ECK4384-JW4355","slt",99,4620553,4622467,1914,"50M","False","f"
"8555","ECK4385-JW4356","trpR",99,4622580,4622883,303,"50M","False","f"
"8557","ECK4386-JW5801","yjjX",99,4623071,4623560,489,"50M","False","r"
"8559","ECK4387-JW4358","ytjC",99,4623617,4624241,624,"50M","False","f"
"8561","ECK4388-JW4359","rob",99,4624279,4625125,846,"50M","False","r"
"8563","ECK4389-JW4360","creA",99,4625341,4625791,450,"50M","False","f"
"8565","ECK4390-JW4361","creB",99,4625827,4626493,666,"50M","False","f"
"8567","ECK4391-JW4362","creC",99,4626516,4627917,1401,"50M","False","f"
"8569","ECK4392-JW4363","creD",99,4627998,4629327,1329,"50M","False","f"
"8571","ECK4393-JW4364","arcA",99,4629428,4630121,693,"50M","False","r"
"8573","ECK4394-JW4365","yjjY",99,4630222,4630339,117,"50M","False","f"
"8575","ECK4395-JW4366","yjtD",99,4630762,4631425,663,"50M","False","f"
